ng	מסגד
outskirts	פרוורים
meticulous	מדוקדק
impregnable	בלתי חדיר
divergence	שונות
ponderous	כבד מאוד
demean	להשפיל
turbulence	מהפכה
outrage	זעם
paternal	אבהי
synonym	סינונים
suceptible	רגיש
intricate	מורכב
swathe	עטף
outpaced	התקדם מהר יותר
spire	צריח
equivocal	מעורפל
convalesce	להחלים
gape	לבהות
demented	מטורף
turbulent	גועש
overdo	להגזים
diagonal	אלכסון
overthrow	הפיכה 2.קריסה
municipal	עירוני
expertise	מומחיות
etcher	חרט
mound	תל
cricket	קריקט (משחק כדור) 2.צרצר
evasive	חמקני
trivial	שולי
eject	לסלק
demolish	להרוס
tutor	להדריך
overhear	לשמוע במקרה
underscored	מודגש
exception	יוצא מן הכלל
fetus	עובר
facades	חזיתות (אדריכלות)
bachelor	בוגר
envisage	חזה
curb	אבן שפה (ברחוב) 2. לרסן
fastidious	בררן
intensity	העמקה
cheeky	חצוף
demolition	הריסה
tyranny	עריצות
overrule	להחליט נגד
undertook	התחייב
with the exception of	למעט
concurred with	להתרחש בו זמנית
strand	גדיל
vacancy	ריקנות
squalid	מטונף
septic	מזוהם
redeem	לפדות
thus	לפיכך
avoidable	שניתן להימנע ממנו
denounce	להאשים
overview	סקירה
inquires	מתחקר
omnivore	אוכל כל
blaspheme	לחלל (דבר קדוש)
realm	ממלכה 2.תחום
alumna	בוגרת מוסד השכלה
sewerage	ביוב
grim	זועף
rediscover	לגלות מחדש
prospect	סיכויים
underfed	שלא קיבל מספיק אוכל או אנרגיה
departure	יציאה
clutch	מצמד 2.אחיזה
admirable	נערץ
composition	הרכב
restraint	איפוק
fraternity	אחווה
municipality	עיר
supremacy	עליונות
refine	לזכך
skimp	להתמקצן
deplore	לגנות
depict	לתאר
tyrant	עריץ
pamphlet	חוברת
thaw	להפשיר
restorts to	פונה ל
bridle	רסן
fleeting	קצר מועד
mascot	קמע
parcel	חבילה
deem	העריך
regime	משטר
kernel	גלעין
gleeful	צוהל
deplete	למצות
undo	לבטל
parachute	לצנוח 2.מצנח
companion	לוויה
ruin	הירס
commanded	ציווה
misadventure	מזל רע (ביש מזל)
disembarked	נחת
negligence	רשלנות
noncturnal	פעיל בלילה
forge	לעצב
igonminious	משפיל
undergo	להתנסות
peck	לנקור
incorporate	לשלב
incorporated into	שולב
resolve	לפתור 2.להחליט
Pivotal	מכריע
fretful	עצבני
curfew	עוצר
poignant	נוקב
enumerate	למנות
correspond	להיות תואם
intoxicate	לשכר (שיכור)
deport	לגרש
underlie	להדגיש 2.להיות מונח ביסוד 3.ממקום מתחת ל
peek	להציץ
trample	רומס
prohibited by	נאסר על ידי
demand	לדרוש
intricately	בצורה מורכבת
slate	כיסה ברעפים
armistice	שביתת נשק
venue	מקום אירוע
lucid	ברור
dispose	לזרוק
conspire	לקשור קשר
deprive	למנוע
undertake	לקחת על עצמו
exhale	נושף
uproar	מהומה
liable	אחראי
curiously	באופן מסקרן 2.באופן מוזר
demolished	נהרס
perception	תפיסה (איך אנחנו חושבים על משהו)
loathe	לתעב
trait	אופי
electrify	לחבר לרשת חשמל 2. לרגש
derive	להסיק מסקנה
uneasy	מודאג
peer	עמית
depart	לעזוב
forbade	לאסור
suffocation	חנק
formats	תבנית
Cramped	מכווץ
aviation	תעופה
limber	גמיש (גוף או אישיות)
distortion	עיוות
collapsible	מתקפל
deputy	סגן
unsion	הרמוניה 2.אחדות
peep	להציץ
affluence	עושר
skating	החלקה
languish	לדעוך
infiltration	הסתננות
industrialist	תעשיין
vintage	בציר 2. כינוי לפריט שערכו עולה ככל שהוא מתיישן
letharagic	אפתי
obedience	משמעת
hyperventilate	לסבול מנשימת יתר
derogatory	מזלזל
ubringing	גידול
petition	עתירה 2.עצומה
etiquette	כללי התנהגות
tactufully	בצורה טקטית
stenographer	קצרן (רשם בבית משפט)
conscientiousness	עבודה בחריצות
debut	הופעה ראשונה
gibe	לגלוג
intrauterine	תוך רחמי
foe	אוייב
persecute	לרדוף
descend	לרשת בירושה 2.לרדת
uphold	לאשר
physician	רופא
oversight	השמטה
mournfully	בצורה עצובה
ambivalence	רגשות סותרים
Probity	יושרה
saucer	צלוחית
sneer	בז
assimilation	הטמעה
enchant	לכשף
species	מין
aflutter	נרגש בציפייה למשהו
deserter	עריק
uplift	הרים
pier	מזח
appeal	מערער
innumerable	עצום
attribute	לייחס 2.תכונה
quota	מכסה (של מקומות)
eschew	נמנע
veil	מסווה
buoy	הציף 2. תמך
enquiry	חקירה
broadcast	לשדר
pump up	לנפח 2. לשלהב
despise	לבוז
synonymous	נרדף
perceptive	חד עין
crowded	צפוף
deterred	הרתיע
stifling	מחניק
woo	לשכנע מישהו שיתמוך בך
encompassing	הקיף
ascribe	לשייך
defiant	סרבן
cold-sweat	זיעה קרה (כתוצאה מפחד)
designate	מיועד
utomost	הגדול ביותר
pillar	עמוד
hiatus	הפסקה זמנית
cogent	משכנע 2.רלוונטי
deducible	ניתן להסקה
immersing	טבילה
stifle	חנק
silhouette	צללית
erosion	סחיפה
audacious	נועז
dubious	מפוקפק
ferment	להתסיס
detach	לנתק
utter	לבטא
pin	סיכה
curator	אוצר (במוזיאון)
mere	רק
propagate	להתרבות 2.להפיץ
adcom	ועדות קבלה (ראשי תיבות)
funnel	ניתב
effusive	קבלה
spill	נשפך
avarice	תאוות בצע
compulsory	חובה
stagger	להתנדנד מצד לצד (ללכת בקושי רב) 2.לסדר בצורה מוזרה
detain	לעכב
utterly	לגמרי
pinch	לצבוט
counterpart	עמית
phobias	פחדים
encompass	לכלול
procrastinate	לדחות דברים
unreceptive	שאינו קשוב
trifle	דבר קטן
doping	סמים
disguise	להסוות
constitution	הרכב
slake	להרוות צימאון למשהו
deter	להרתיע
utility	שימושיות
pinpoint	לאתר במדויק
boast	מתרברב
humming	זמזום
bend	לעקם
glance	מבט חטוף
tumble	נפילה
dull	אדיש
stint	קדנציה
distinct	מובחן
reprimand	לנזוף
baffle	לבלבל
detest	לשנוא
plain	מישור 2.פשוט
sewing	תפירה
vociferous	רעשני
impartiality	ניטרליות
scenery	נוף
unionize	להתאגד
weave	ארג
backlash	תקופת נגד חריפה
convene	להתכנס
abbreviate	לקצר
recuperate	להחלים
detract	לגרוע
operated	הפעילו
aviator	טייס
grime	זיהם
communicative	תקשורתי
parlayed	מינוף
juxtaposition	סמיכות
armchair	כורסה
apnea	דום נשימה
defect	לערוק
puppy love	אהבת נעורים
detrimental	מזיק
injection	זריקה
platter	מגש
contemplate	להרהר
vetoed	להטיל וטו
interpret	לפרש
conferences	ועידות
thererunder	מתחתיו
opulence	עושר
fin	סנפיר
defintive	סופי
corollary	תולדה
ramification	השלכות
devise	לתכנן
gradual	הדרגתי
plot	עלילה 2.מזימה
gait	הליכה
distilled	מזוקק
respectively	בהתאמה
inhibition	מעכב
wistful	מלא געגוע (בצורה שלילית ועצובה)
binding	עטיפה
contentious	שנוי במחלוקת
candid	כן
impartial	נטרלי
fluctuate	להתנדנד
devote	להקדיש
intimidate	להפחיד
plug	תקע 2.מצת 3.פקק
senesce	הזדקנות
radish	צנון
inspector	מפקח
pertinent	רלוונטי
flippancy	קלות דעת
august	אצילי
ignite	הצית
cohesive	מלוכד
serene	שליו
impoverish	לרושש
devotion	התמסרות
executive	מנהל
pole	מוט 2.קוטב
integrate	לשלב
permanent	תמידי
shrewdness	פיקחות
liturgical	פולחני
bliss	אושר עילאי
languid	נרפה
sanction	סנקציה
condone	למחול
intact	שלם
devour	לזלול
collaborator	משתפי פעולה
pounce	להתנפל
leap	זינוק
heirloom	ירושה
distribution	הפצה
discrepant	חריג
slot	חריך
depicted	תיאר
potency	כוח
conjecture	לשער
basin	אגן
opportune	מה שקרה בעיתוי מוצלח
deviate	לחרוג
subordinate	כפוף ל
powder	אבקה
flare	להבה
postal	של דואר
administrator	מנהל
compatible	מתאים
panel	קבוצה של אנשים שמכתנסים לשירות כלשהו
agitation	תסיסה
admission	הכנסה
diligent	חרוץ
sincerity	כנות
fallacious	מטעה
deviation	חריגה
needlessly	ללא הצורך
precipitation	משקעים
gloat	שמחה לאיד
avid	להוט
carcass	פגר
hub	מרכז
dissuade	הניא (גרם למשהו לא לקרות)
incognito	בעילום שם
showdown	עימות מכריע
disdain	לבוז
hearsay	שמועה
renovate	לשפץ
devoid	חסר
imperceptibility	באופן בלתי מורגש
preoccupation	טרדה
bred	לגדל 2.להתרבות 3.להפרות
enterprise	יוזמה
consult	להתייעץ
wage	שכר
coarse	גס
furnish	לרהט
underscoring	הדגשה
sneak	להתגנב
eclectic	בררני
inferior	נחות
devout	אדוק
adversely	בצורה מנוגדת
proceed	להמשיך
swept	טאטא
linguistic	בלשני
deceit	רמאות
collar	צווארון (בבגד) 2.קולר לבעלי חיים
wacky	מטורף
entangle	סיבך
garner	אסף
solitude	בדידות
amiss	לא כשורה
diagnose	לאבחן
abducted	נחטף
profession	מקצוע 2.הצהרה
bound	קשור
neural	עצבי
deficient	חסר
unhinged	משוגע
forgery	זיוף
eloquent	רהוט
emphasis	דגש
nominal	סמלי
insulation	בידוד
remark	הערה
prohibit	לאסור
shrunk	כיווץ
unveiled	חשף
demonstration	הוכחה
void	ריק
dissect	ביתר
waylaid	מונחת בדרך
elementary	יסודי
fuse	נתיך 2. להתמזג
obscure	מעורפל
thrust	דחף
dictate	לפקד 2.להכתיב (לומר למישהו מה לכתוב)
stripe	פס
prophecy	נבואה
indignant	ממורמר
fierce	פראי
inherent	שטבוע במהות של דבר
raking	גריפה
lukewarm	פושר
commended	שיבח
embellished	יפה
futile	עקר
recluse	מתבודד
derivation	הוכחה (לוגית)
dictation	הכתבה
adaptation	הסתגלות
pump	לשאוב
elusive	חמקמק
cardboard	קרטון
on account of	בגלל
bummed	מאוכזב
frenetic	משוגע
pillaged	בזז
alleged	כביכול
intimate	לרמוז
malignant	מרושע
eulogize	לפאר ולשבח
differ	לחלוק על
encounter	מפגש
qualification	הכשרה
bead	חרוז (שרשרת) 2.אגל
petulant	קצר רוח
outreach	פנייה יזומה
steep	גבוה
betrothal	אירוסין
passionate	נלהט
intractable	קשה לשליטה
immense	עצום
tale	סיפור
diffuse	להתפזר
query	לשאול
maritime	ימי
Imbecile	אידיוט
preach	לשאת דרשה
credibility	יכולת
cabinet	ארון
ambitious	שאפתן
intrepid	חסר פחד
confidential	סודי
dignify	לכבד
ratio	יחס
marine	ימי
obstinacy	עקשנות
redundant	מיותר
receptionist	פקיד קבלה
franchise	זיכיון
incisive	נוקב
interfere with	התערב עם
intrinsic	פנימי
reconcile	להשלים
modify	לתקן
dignified	מכובד
imperious	שחצן
feud	מריבה
shrugged	משך בכתפיים
roam	לשוטט
showcase	הציג לראווה
rambles	שוטטות ללא מטרה מסוימת
whence	מאין
whether	אם
introversion	פנימיות  (אופי)
yearn	להתגעגע
thorax	חזה
diligence	התמדה
imperial	קיסרי
reap	לקצור
equation	משוואה
loin	ירך
attend	לטפל 2.להיות נוכח
vouch	העיד
bureaucratic	שקשור לבירוקרטיה
sequel	המשך
either	אחד מהשניים
prestige	יוקרה
flagrant	בוטה
rebellion	מרד
hollow	חלול
assert	הכריז 2.עמד על דעתו 3.טען
whereby	באמצעותו
cusp	חוד 2.חצי סהר
lawnmower	מכסחת דשא
mew	יללה
tempt	פיתה
pretentious	יומרני
confine	להגביל
supposition	השערה
dilute	לדלל
accomplice	שותף לעבירה
recitation	דקלום
pledged	התחייב
sweeping	סוחף 2.כוללני
daunted	מפוחד
pinnacle	שיא
dainty	עדין
trace	עקבות
prevail	לגבור
conspicuous	בולט
slight	מעט
dim	לעמעם (תאורה)
successor	יורש
reclaim	לדרוש בחזרה
shrill	לצווח
by 776 B.C.E	עד שנת 776 לפני הספירה
spring	אביב 2.לזנק
elective	בחירה
enclosure	כיתר
bonnet	מצנפת 2. מכסה מנוע
tame	לביית
gainsay	להכחיש
afflict	לייסר
comparative	יחסי
diminish	להמעיט
advocate	תומך
recruitment	גיוס
meek	צנוע
veneer	שכבה דקה של משהו יקר
sufficiently	באופן שיספק
obstetrics	מיילד
rampage	השתולל
ominous	מבשר רעות
monument	אנדרטה
gall	להרגיז
candidly	בכנות
dire	דחוף 2.גרוע
supervisor	מפקח
regards	דרישת שלום
pacifying	פיוס
lodged	התגורר
accompany	להתלוות
copay	השתתפות עצמית
tenuous	יש לו קצת חוזק או חומר
neat	מסודר
resentment	כעס
galvanize	להמריץ
deterrent	מעכב
defiance	סירוב בתוקף
discard	לזרוק
symmetric	זהה בשני צדדיו
relent	לוותר 2.להתמתן
retrieving	השבה של משהו
attire	הלביש
account for	להסביר
coverage	סיקור
horde	המון
clergyman	כומר
accompaniment	ליווי
gambit	מהלך טקטי (בשחמט
dispensable	לא הכרחי
defection	עריקה
discern	להבדיל
reminder	תזכורת
simmering	הרתחה
esteem	הערכה
adversary	יריב
bundle	ארז
retribution	עונש
expostulate	התווכח
instrument	כלי 2. מסמך רשמי
garish	צעקני
pursue	לרדוף
smother	לכסות
discord	להתווכח
syntheic	מלאכותי
representation	ייצוג
margins	שוליים
keeps up with	עומד בקצב עם
amenities	שירותים הניתנים על ידי מקום
whereabouts	היכן
idler	בטלן
cut down for	קיצוץ עבור
brew	לבשל (חליטה או שכר - בירה)
undermine	לחתור תחת
unison	ביחד
discredit	לבייש
glamorous	זוהר
format	פורמט
annex	סיפח
amenity	נוחות 2.גינונים
amalgamate	מיזג
portray	תיאר
infuriate	הרגיז
eulogy	הספד
interim	זמני
discrepancy	סתירה
fond	אוהב
repulsive	דוחה
scales	מאזניים
aptitude	נטייה
apposite	מתאים מאוד
bickering	התקוטטות
gruesome	מבעית
menaced	איים
enlightened	נאור
hitherto	עד כה
discrete	מובחן
enriched	מועשר
drawback	חסרון
barracks	מגורי חיילים
stir	לרגש 2.לבחוש
pawn	מישכון
neutral	נטרלי
devastated	הרוס
indecent	מגונה
composite	מורכב
intense	עז
resort	מפלט 2.אתר נופש 3.לנקוט
convent	מנזר
filth	לכלוך
beforehand	מראש
undermining	לחתור תחת
hedge	גידר
reproachful	נוזף
wiped out	מחוק
upkeep	תחזוקה
blasphemy	חילול השם
disenchanted	להתפכח מאשליה
illiteracy	אנאפלבתיות
restrain	לרסן
deceptive	מטעה
relatively	באופן יחסי
assassinating	מתנקש
resolute	נחוש
held back	מנע
jurisdiction	תחום שיפוט
dread	לפחד
vapor	אד
disgrace	לבייש
illegitimacy	ממזרות 2.אי לגיטמיות
retail	למכור בקמעונות
imposing	מרשים
lavishly	בנדיבות
cede	לוותר על
harbor	נמל 2.מחסה
awry	עקום
preposterous	אבסורדי
shown off	השוויץ
blot	כתם
complaisance	אדיבות
disillusionment	התפכחות (מאשליה)
illegality	אי חוקיות
retell	לספר מחדש
least	פחות
acutely	בצורה חמורה
conscience	מצפון
comprising	כולל
callow	טירון
fasteners	אבזר המשמש לסגירה
contagion	הדבקות
saturnine	עצוב
illegibility	חוסר בהירות
retrace	לשחזר
caution	זהירות
azure	תכלת
garret	עליית גג
dashing	נמרץ
convicted	מורשע
sovereignty	ריבונות
implant	להטביע
dote	להרעיף אהבה וחום
disperse	להפיץ
extract	להפיק
renovated	שופץ
burst	התפרץ 2.פוצץ
detection	מלאכת האיתור
postoperative	לאחר ניתוח
stupor	ערפול חושים
aquiline	נשרי (כמו נשר)
omniscient	שיודע הכל
convulse	טלטל
blashpheme	לחלל (דבר קדוש)
various	שונה
dispute	להתווכח
arbitrate	להכריע 2.לתווך
irresistibly	שאין לעמוד בפניו
strenuous	מאמץ
materialized	הופך להיות ממשי
armpit	בית שחי
perch	ממוקם
jubliant	צוהל
culprit	נאשם
fundamentalist	מאמין בתורה שבעל פה
remnant	שריד
disseminate	להפיץ
venture	השקעה
unfold	נפרש
legible	קריא
lent	הילווה 2.נתן
reclusive	מתבודד
bust	שבר
shabby	עלוב
impose	כפה
atrocity	זוועה
stench	סירחון
dissent	להתנגד
verifiable	ניתן לבירור
enact	לחוקק
portable	נייד
all but	כמעט לגמרי 2.הכל חוץ מ.
quarrel	ריב
washout	כישלון חרוץ
fare	דמי נסיעה
obtained	הושג
ratify	אישר
tiresome	מייגע
dissolve	להיעלם 2.להתמוסס
vessel	כלי דם 2.כלי קיבול 3.כלי שיט
trickle	לטפטף
interceded	להתערב 2.הליץ בעד מישהו אחר
ratified	אישר
eavesdrop	לצותת
repercussion	השלכות
curriculum	תוכנית לימודים
bridegroom	חתן
accommodate	העניק
malice	רוע
distaste	לסלוד
vicious	אכזרי
stationary	נייח
deposited	הפקיד
secession	פרישה
languor	חולשה
defying	מתנגד
trousers	מכנסיים
extradition	הסגרה (לידי מדינה אחרת)
apprehension	דאגה
expedition	מסע
abolish	לבטל
distasteful	לא נעים
virtual	מדומה
roast	צלוי
deferred	דחה
spectacle	מחזה
ruptured	נקרע
quotation	ציטוט 2. הצעת מחיר
occupant	דייר
espionage	ריגול
gilding	הזהיב (ציפה בזהב)
precede	תקדים
calamity	אסון
distort	לעוות
virtually	למעשה
humid	לח
debuted	הושק
suburb	פרור
rout	להנחיל תבוסה
loom	מכונת אריגה 2. הגיח
rumble	הרעיש
leveraging	מינוף
flagship	ספינת דגל 2. הדבר המובחר
deception	רמאות
bulletin	להודיע
vacant	פנוי
craft	מלאכה 2.מיומנות
inconspicuous	לא בולט
offspring	צאצא
staunch	נאמן
perspire	הזיע
gleam	הבריק
condemnation	הרשעה
swell	התנפח
avaricious	כילי
pageantry	תצוגה מרהיבה
district	אזור
tenant	דייר
emblematic	סמלי
dump	זבל 2.פלט של נתונים ממסד של נתונים
plaza	כיכר העיר
platitude	אמרה שטחית ונדושה
copper	נחושת
solidifies	מיצק
ditch	לעזוב
ostentatious	ראוותני
pale	חיוור
doom	אסון
vague	מעורפל
vengeance	נקמה
stocky	איתן
illusory	מטעה
depleted	מדולל
lecture	הרצאה
scuffle	נאבק
commodity	סחורה
juxtapose	לשים בסמוך
dormant	רדום
vagueness	אי בהירות
retort	תשובה חריפה ושנונה
excessively	בצורה מוגזמת
untold	שלא ניתן לתאר במילים 2.כביר
heresy	כפירה
flurry	התרגשות
hosed	השקה 2. רימה
ulster	מעיל כבד
allay	הרגיע
lard	שומן חזיר
pan	מחבת
vain	יהיר
recoup	לפצות
responsive	מגיב
sustained	ממושך
insuperable	שלא ניתן להתגבר עליו
protruded	בולט
hideously	בצורה איומה וזוועתית
quest	מסע
exemplary	מופתי 2. מזהיר
capsized	התהפך
susceptible	רגיש
pander	לספק
downcast	מדוכא
in vain	לחינם
delinquency	עבריינות
cautious	זהיר
fluctuated	תנודות
maneuver	תמרון
spare	חס
sway	התנודד 2. השפיע
tremendous	עצום
quail	רעד
drab	אפרורי
err	שגה
pedal	לדווש
majesty	מלכות
pardon	סלח
retaliation	גמול
buffoon	ליצן
taint	לפגום
inked with	מסומן בדיו
wharf	מזח
fasten	לסגור היטב
parlor	דוכן
ransack	בזז
pardoning	חנינה (שנשיא נותן או אדם שביקשו ממנו סליחה)
batch	קבוצה
leopard	פנתר
ulterior	נסתר
dreary	עצוב
verdict	פסק דין
immunized to	מחוסן
extent	היקף
ease	להקל
pluck	לקטוף
stark	פשוט
imprudent	חסר זהירות
resign	התפטר
jeopardize	סיכן
wander	לשוטט
vacate	להתפנות
droll	משעשע
versatile	מגוון
prearranged for	מסודר בראש
imbalanced	חוסר איזון
furtive	חשאי 2.ערמומי
augment	מגביר
gaudy	צבעוני מדי
hindrance	מניעה
outcry	זעקה
waistline	קו מותן
contamination	זיהום
veteran	יוצא צבא 2.ותיק
weary	לייגע
seamless	בלי תפרים
implicit	מרומז 2.משתמע
obfuscates	מעורפל
glittering	נצנץ
indebted	אסיר תודה
flank	איגף - נע סביב
bleach	הלבין
disinfect	לחטא
tender	ברכות
overdue	שעבר זמנו
vibrant	מלא חיים
provocation	פרובקציה
cowardice	פחדנות
spool	גליל 2.קובץ שנשמרים בו דברים להדפסה
defamation	השמצה
continuous	רציף
poached	חלוט
indignation	התמרמרות או זעם בעקבות אי צדק
quotidian	יום יומי
immensely	לאין שיעור
bolster	תמך
disinfectant	חומר חיטוי
fortify	לבצר
last	אחרון 2.סופי
toss	זרק
implicate	לערב
enigmatic	חידתי
imps	שד
flammable	דליקה
soothed	הרגיע
elevate	להגביה
vigor	חוזק
pasture	שדה מרעה
sought	לחפש 2.לבקש
besting	גבר על
deliberation	שקילה
saner	שפוי
florid	פרחוני
turnout	שיעור השתתפות
gargled	לגרגר
reverent	יראת שמיים
impede	להפריע
encircle	לכתר
vigorous	איתן
occasion	אירוע 2.סיבה
theorem	תאוריה שהיא מוכחת
intoxicating	משכר
superstitious	לא מציאותי
gravel	חצץ
fiery	לוהט
clause	פסקה
tangles	הסתבך
wince	להתכווץ
enigma	מסתורין
vindictive	נקמני
abbey	מנזר
plunge	לצלול
unabashedly	ללא בושה
outspread	פרוש
ablaze	בוער
recess	הפסקה
cordially	בלבביות
capitalize	הפיק תועלת ממשהו 2. השתמש באות גדולה
ingot	מטיל
partucles	חלקיקים
orge	ענק מפלצתי
entertain	לארח
rework	לעבד מחדש
pod	תרמיל
awestruck	מוכה יראת כבוד
lull	הרגיע
gnaw	כירסם
utmost	מיטב היכולת
calf	גור של יונק לעיתים קרובות עגל
virtues	מעלות
shortfall	גירעון
eradicate	להשמיד
virtue	מעלה
rid	להיפטר
poise	לאזן
undertaken	קיבל על עצמו
assertion	טענה תקיפה
deducted	נוכה
mandate	מנדט
humdrum	שגרה
retention	שמירה
hermit	נזיר
compress	לדחוס
eternal	אינסופי
vivacious	מלא חיים
ridden	חדור 2.נשלט על ידי
hauls	לגרור
overruled	פסק נגד
unrequited	ללא גמול (כשמדובר על חיבה ואהבה)
pile	ערם
compatriot	בן-ארצו
camouflage	הסוואה
thread	פתיל
evacuate	לפנות
ponder	להרהר
misperception	תפיסה מוטעית
fundameltalist	שמרן קיצוני
exempt	לפטור
whimsical	שובב
singular	יחיד
lament	קונן
ray	קרן
paste	להדביק 2. עיסה
mellow	רגוע
evaporate	להתאדות
volume	קול 2.נפח 3.כרך מסוים של ספר
rough	מחוספס
porter	שוער
lampshade	כיסוי למנורה
imperil	לסכן
hogwash	שטויות
puffed	נשף
contingency	משהו שעלול לקרות
strip	רצועה 2. התערטלות
promptly	ללא עיכוב
amplify	להגביר
exile	לגרש
salvage	לחלץ
precaution	אמצעי זהירות
aboard	על כלי תחבורה כלשהו
repatriation	חזרה למולדת
riddance	השתחררות (כמו get rid from something)
chagrin	צער
defies	התריס
chanted	זרה
excite	להלהיב
vow	להישבע
sample	לדגום
sumptuary	חוקיים שקשורים לכספים
expenditure	הוצאה
bolstered	חיזק
robust	חסון
gospel	בשורה
pedometers	מד צעדים
compile	ליקט
riddle	חידה
spew	להקיא
exclusive	בלעדי
voyage	לנסוע 2.מסע 3.הפלגה
savage	פראי
predecessor	אב קדמון 2.קודם בתפקיד
cloth	בד אריג 2.גלימת כומר
recount	לספור מחדש 2.לחדש
bland	תפל
breastpin	סיכת חזה
uncertainty	אי ודאות
timid	ביישן
furnished	רוהט
rooster	תרנגול
execute	לבצע
vulnerable	פגיע
scarf	צעיף
predominate	לשלוט
concave	קיעור
pest	מטרד
sect	פלג
sapped	החליש
shipwreck	הרס של ספינה
lingering	ממושך
gazelle	צבי
warehouse	לאחסן במחסן
scatter	לפזר
prepay	לשלם מראש
mesh	רשת 2.סבך
pollen	אבקה (של צמחים)
nuance	הבדל דק ועדין
jest	בדיחה
combustion	בעירה
poles	קטבים
overstated	הגזים
tumult	המולה
astonishment	תדהמה
warn	להזהיר
scenario	תרחיש
prerequisite	תנאי מוקדם
epitaph	הספד 2.כתובה על מצבה
eclipse	ליקוי
plumber	שרברב
blowout	פנצ'ר
indulgence of	סיפוק של
outlasted	האריכו זמן יותר מ
descend from	לנבוע ממקור כלשהו
wear	ללבוש 2.להחזיק
rather than	ולא; במקום
nocturnal	של הלילה
coerced	אולץ
copulate	להזדווג
ejaculated	פלט
equilibrium	שיווי משקל
illumination of	הארה ל
skyrocketed	נסקו
enroll	להירשם
outline	מתאר
wear off	להיעלם
scrabble	לשרבט 2.להיאבק 3.שבץ נא
pretext	אמתלה
assimilate	להטמיע
blabbering	פטפט
besotted	מאוהב לגמרי ולא יכול להפסיק לחשוב עליה
vice	סגן
Doomsday	יום הדין
allusion to	אזכור ל
tube	צינור
chapel	כנסייה
sketches	סקיצות
wear down	לייגע
screw	בורג
suction	יניקה
jester	ליצן החצר
guardrails	מעקה בטיחות
unsanctioned	ללא אישור
widower	אלמן
stalled	עיכב
ascension to	עליה בדרגה
breed	זן
acclaim	להריע
exploit	להשתמש
wear out	להתבלות
scribble	לשרבט
primate	יונק
no sooner.. than	ברגע ש
on par	שווה ערך
amass	לצבור
twig	זרד
bale	חבילה
export	לייצא
welfare	סעד
sculpt	לפסל
prime	ראשי 2.מיטב
avert	הפנה
cursory	חפוז
bungalow	בית נופש קטן
interfere	התערב
consecration	קידוש
detached	מנותק
intent	כוונה
cast	להטיל
widen	להרחיב
seal	לאטום 2.חותמת
probe	לחקור
string	חוט 2.רצף
credential	תעודה 2.מכתב המלצה
gulf	מפרץ
tint	צבע
footage	קטע של סרט
content	תוכן
catalyze	לזרז תגובה כימית
strife	עימות
width	רוחב
self -centered	אנוכי
proclaim	להצהיר
dexterity	מיומנות
levity	קלות ראש
wedge	טריז (להפריד שני חפצים)
colonialist	מתיישב
elated	לרומם את המצב רוח
will	לחפוץ
self-destructive	בעל נטיה להרס עצמי
nonetheless	למרות זאת
prerogative	זכות
chaise	כרכרה
groan	גנח
revert	חזר
lobbyist	נציג
descent	מוצא
faint	עמום
wind	רוח
prodigy	עילוי
furthermore	יתרה מכך
lesion	נגע
maintenance	תחזוקה
pluralist	מאמין בריבוי דעות
fallible	עלול לטעות
elude	לברוח
wink	לקרוץ
shrug	למשוך בכתפיים
proficiency	מיומנות
otherwise	ולא
reparation	פיצוי
tantalizing	מפתה
vex	הרגיז
endeavor	מאמץ
initate	להתחיל
garnish	לקשט
embargo	להטיל חרם
wipe	להשמיד
shut	לסגור
proliferation	התרבות מהירה
contemplative	מהורהר
meddles with	מתערב עם
ludicrous	מגוחך
caprice	קפריזה
avail	הועיל
congestion	דחוס
emergent	הולך ומתגבש
idiom	ניב
embark	להתחיל להעלות על אוניה או מטוס
wipe out	להחריב
shuttle	מעבורת 2.להסיע הלוך ושוב
prominence	התבלטות
fictitous	בדוי
delves into	מתעמק
stilled	להרגיע
temper	מצב רוח
billet	הקצאה למגורים
redirected	כיוון מחדש
trim	קצץ
vertebrae	חוליות עמוד השדרה
illicit	לא חוקי
emblem	סימן
withdrawal	גמילה 2יציאה
sink	לשקוע
propel	להניע
erratic	לא אחיד
disquiet	אי שקט
solace	נחמה
ink	דיו
mitigate	הקל
imagery	דימוי
גחמה	עיקשות
embody	להכיל
workshop	בית מלאכה 2.קורס
soar	להמריא
proponent	חסיד
assembly	אסיפה
foolscap	דף נייר
secure	הגן 2. שמר משהו במקום 3. סגר
pseudonym	שם בדוי
emulate	להשתוות עם מישהו 2.לחקות
worship	להעריץ
so-called	כביכול
proprietary	זכות לבעלות או קניין
presence	נוכחות
overlapping	חופף
confabulation	בדיות
niece	אחיינית
solicitor	עורך דין
hesitancy	הססנות
incentive	תמריץ
theme	נושא מרכזי
carpenter	נגר
soothe	להרגיע
prosecute	לתבוע
pavement	מדרכה
expedient	אמצעי 2.כדאי
brandishing	הנפה
scold	גער
gypsy	צועני
subsidy	תמיכה כספית
upbringing	גידול
endorse	לאשר
wail	לילל
souvenir	מזכרת
protagonist	גיבור העלילה
tinkering	התעסקות
indelible	בלתי ניתן למחיקה
sultry	מחניק
assuage	מרכך
boos	קרא קריאת בוז
hallmark	סימן היכר
endow	להעניק
spear	חנית 2.לדקור
punctuate	לפסק
reconciliation	פיוס
crave	להשתוקק
cognition	חשיבה
thigh	ירך
discontent	אי שביעות רצון
faithful	נאמן
endowed with	ניחן (בתכונה מסוימת)
quarantine	הסגר
indispensable	חיוני
wallow	להתפלש
florist	מוכר פרחים
incite	הסית
piety	אדיקות
surpassing	מצויין
authoritative	סמכותי
delegation	משלחת
enfeeble	להחליש
waste	לדלדל
sphere	כדור 2.כיפת השמיים 3.תחום בו מתרחשת פעילות מסוימת
bloat	להתפיח
presumably	ככל הנראה
dabble	להתעסק בעבודה כלשהי
dictum	הצהרה
miscarriage	הפלה (טבעית) 2. כישלון
procure	להשיג משהו שקשה להשגה
cornerstone	אבן פינה (מטאפורה לבסיס)
spoil	לקלקל 2.לפנק 3.לבזוז
pretension	יומרה
unwind	להירגע 2.להתיר (לפרום קשר)
usher	סדרן 2.שומר
enlighten	להדריך
wasteful	בזבזבני
sprawl	להשתרע
raft	רפסודה
overturn	הפך
chattel	נכס נייד
Subpostmasters	סגן מנהל משרד דואר
kindle	להבעיר
eminence	נכבדות
enraged	להרגיז
stamp	חותמת
bibliophile	אוהב ספרים
intermediaries	מתווכים
colloquially	באופן דיבורי
tenure	הזמן שבן אדם עובד בעבודה מסוימת
compensate	פיצה
excerpts	קטעים
standout	לבלוט 2.לסרב
extracted	חולץ
unprecedented	חסר תקדים (שכמוהו עוד לא היה)
invariable	קבוע
coherence	עקביות
entice	להסית
weep	לבכות
standstill	לעמוד ללא תנועה 2.מבוי סתום
ravage	להרוס
ubiquitous	נמצא בכל מקום
bystander	משקיף
sediment	שיקע
apprehend	תפס
lamp	מנורה
thorough	יסודי
foregone	פורשים מראש
steer	לנווט
namely	כלומר
subjugate	לשעבד
brandish	איים 2.נופף
tan	להשתזף
salute	הצדעה
fork	מזלג
epoch	תקופה
entrust	להסמיך
reassemble	לקבץ מחדש
taunt	להתגרות
inquiry	חקירה 2.שאלה
heinous	רע
boasted	התפאר
commemorate	הנציח (בזיכרון)
entitled	ראוי
bouquet	זר
entwine	לשזור
whereas	לעומת זאת
stray	לתעות 2.מקרי
gauge	מודד
spectacular	מרהיב
bloc	גוש
buttock	עכוז
rally	אסיפה
asserted	הכריז
realms	ממלכות
matriarchal	שלטון האם (מטריכלי)
swelled	להתנפח
enslave	לשעבד
whine	בכיינות
recapitulate	לסכם
rehabilitation	שיקום
secede	פרש
explicit	מבוטא
reverted	חזר למצב הקודם
deteriorate	להדרדר
precept	עדות
envision	לחזות
stud	סוס הרבעה 2.לנעוץ
recession	שפל
superficial	שיטחי
discerning	נבון
creek	ערוץ
encompassed	הקיף
pundit	מומחה
salvaged	חולץ
blunder	מפשל
equate	להעריך כשווה
whirl	מהומה 2.לסובבב
reciprocity	הדדיות
coincidental	מקרי
heyday	תקופת השיא
certificate	תעודה
lax	רפוי
elicit	הפיק
crane	עגורן
cackles	קרקורים
whole	בריא ושלם 2.כולל 3.מקיף
summon	לזמן
recompose	להרכיב מחדש 2.להירגע
lie	שקר 2.נמצא
horticulture	גננות (גידול צמחים)
arson	הצתה
disparity	פער
scrutiny	בחינה
excavation	חפירה
digest	תמצית
era	עידן
wholesale	סיטונאות
sunbathe	להשתזף
venturing	מעז
tenet	עיקרון
plead	לטעון
plebiscite	משאל עם
convict	אסיר
meadow	אחו
wholly	לגמרי
swirl	להסתחרר 2.מערובלת
rectangular	מלבני
perishing	נחרב
vortex	מערבולת
vanity	יוהרה
inclusivity	כוללני
foster	לטפח
frivolous	קל דעת
particles	חלקיקים
erecrt	להזדקף
wholesome	בריא 2.טוב
tailor	חייט 2.לתפור
recurrence	הישנות
projecting	מתכנן
hound	כלב ציד (משהו שרודף)
hawker	רוכל
malfeasance	עבירה
Eligibility	כשירות
drape	וילון
knot	קשר
sequences	סדרות
reclining	נשען
quacking	געגעוע של ברווז
erode	לאכל
withhold	לא לתת
terrestrial	קרקעי
reevaluate	להעריך מחדש
pursuit	מרדף
recreational	פנאי
banquet	משתה
wicked	רע
refrain	להימנע מ
soared	האמיר
sketched	משורטט
exuberant	צוהל
siege	מצור
immersive	סוחף
erroneous	שגוי
wickedness	רוע לב
thrive	לשגשג
regenerate	להתחדש 2.לתקן
limped	צלע
reigned	שלט
aviary	כלוב לעופות ולציפורים
dodge	התחמק
mischief	שובבות
erudition	השכלה
widow	אלמנה
tide	גאות ושפל
regimen	משטר טיפולי (אורח חיים מסוים לשיפור המצב הבריאותי)
pounced	התנפל
gross	חישב שכר ברוטו
Visitation	הפעולה של הביקור
trespassing	הסגת גבול
annihilation	השמדה
observant	חד הבחנה
estate	נכס
tire	צמיג 2.לעייף
regiment	יחידה צבאית
drifted	נדד
pretence	העמדת פנים
reciprocate	החזיר
scrupulous	מוקפד
wipes	מגבונים
supremacist	עליונות
radiant	קורן
estrange	להתנכר
windmill	טחנת רוח
tomb	קבר
reimburse	לפצות
deceive	להונות
vexing	מעצבן
loo	שירותים
shiver	לרעוד
witty	פיקחות
toolbox	ארגז כלים
rein	מושכות המשמשות לרכיבה 2.לרסן
cylinder	צילנדר
resent	להתרעם
muck	דשן
sewer	ביוב
dual	זוגי
rationing	קיצוב
rebellious	מרדני
outlandish	מוזר
fatbergs	גוש של שומן
grease	שומני
sprung	קפץ
implication	משמעות
wither	לנבול
relay	תחנת ממסר 2.מחליף משמרת 3.מרוץ שליחים
jut	בלט
impartially	ללא העדפה
evict	לגרש
transaction	עסקה
relinquish	לוותר 2.לנטוש
fabric	בד
dangle	התנודד
cluster	אגד
charities	ארגוני צדקה
burden	עול
valiantly	באופן נועז
exasperate	להחמיר
woolen	צמרי
transmit	לשדר
render	להגיש
pesticides	חומרי הדברה
archive	ארכיון
commission	שליחות
parole	שחרור על תנאי
repeal	לבטל
morbid	מבעית
excavate	לחפור
wreck	להחריב
transparency	שקיפות
repel	לדחות
condiserably	במידה ניכרת
laud	הילל
defy	לסרב בתוקף
resentful	כועס
exceed	לחרוג
wreckage	הרס
treaty	אמנה
representative	נציג
conveniently	בצורה נוחה
gilded	מוזהב
eidetic	זיכרון צילומי
savvy	שמבין עניין
acquisition	רכישה
by no means	בשום אופן לא
sober	פיכח
excursion	טיול
wrestle	להתגושש
undisturbed	שלא הופרע 2.רגוע
resonate	להדהד
congregate	מתקהל
vermin	שרצים
dean	דיקן
clamp	מלחציים (לקבע מוצר כלשהו לצורך עיבודו)
pageant	מפגן ראווה
component	חלק
curdle	להקריש
exhilarate	מרענן
wring	לסחוט(מנוזל) 2.לפתל
resort to	לנקוט
tin	בדיל 2.פחית שימורים
fictitious	דמיוני
draftsman	מישהו משרטט כעבודה
mischievous	שובב
handicapped	נכה
jam	פקק תנועה
rebuttal	הכחשה
lid	מכסה 2.עפעף
gauged	נמדד
exclaim	לקרוא
wrinkle	להתקמט
restoration	שחזור
rattling	חריקה
incandescent	זוהר
iteration	חזרה
county	מחוז
preclude	למנוע מאירוע להתקיים
keen	נלהב
exemplify	להדגים
yawn	לפהק 2.להיפער
restriction	הגבלה
foreigner	זר
strained	מודאג
troubleshoot	לפתור בעיות
displacement	הזזה
virtuous	מוסרי
enlist	לגייס
knuckle	פרק האצבעות
retain	לאגור
table	שולחן 2.לוח 3.טבלה
enunciating	לבטא
shelved	לא התממש (כמו ששמו משהו במדף ולא נגעו בו יותר)
abdication	ויתור על כס המלכות 2. התפטרות
sewage	שפכים
maverick	עצמאי
lag	להתמהמה
zenith	פסגה
cuneiform	כתב יתדות
dome	כיפה
patenting	פטנט
accession	קבלה (של משרה
consort	בן או בת זוג
troupe	להקה
lamb	כבש
expulsion	גירוש
zest	להוסיף עניין 2.לתבל 3.התלהבות
via	באמצעות
row	שורה 2.חתירה
louts	גס רוח
penniless	חסר פרוטה
perish	נהרס
riot	התפרות
sinister	רע
oblique	אלכסוני
expurgate	לצנזר
zip	לרכסן
Vindication	זיכוי
presumed	משוער
pangs	ייסורים
superintendent	מפקח
obliterate	להשמיד
extant	שורר
zipper	רוכסן
wagon	קרון
revision	בדיקה מחדש
fountain	מזרקה 2.מקור של משהו (בהשאלה)
plagued	מוטרד
thump	חבטה
turmoil	בלגן
cordon	סרט שמונע מאנים להיכנס לאזור
phase	שלב (זמן)
entrant	מצטרף
cartridge	תרמיל 2.מחסנית
intrigued	לסקרן
extinguish	לכבות
evangelicals	צליינים
weaver	אורג
rhyme	לחרוז
fretsaw	מסורית (מין מסור ידני כזה)
undercutting	לחייב פחות מהמתחרה
kennel	מלונה
extort	לסחוט (כסף)
vicinity	סביבה
wed	להתחתן 2.לאחד
rife	שופע
pheasant	סוג של ציפור
incorporated	לשלב
discourtesy	לא מנומס
coil	סליל
garland	זר פרחים
secularized	חילון
extraneous	לא נחוץ
wary	זהיר
wig	פאה
rite	טקס
perpendicular	ניצבי
porridge	דייסה
barricade	מתרס
forerunner	שליח
glimpse	מבט חטוף
clergy	כמורה
pave	לסלול
extravagant	ראוותני
rotor	נע במעגלים (חוגה) 2.החלק שנע במנוע
bisect	חצה (לשתי גדלים שווים)
fermented	להתסיס
peculiar	לא רגיל
billy	מיכל לחימום מים 2. אלה שמשמשת שוטרים להכאה
ambiguous	דו משמעי
whip	שוט 2.להלקות
rouge	סומק
slab	חתיכה עבה
brewed	לבשל
whims	גחמה
reinterpreted	לפרש משהו מחדש
gnawed	נגס
obnoxious	נתעב
fatal	הרה אסון
woe	יגון
pact	הסכם
rudimentary	בסיסי
guileless	ישר
stalk	גבעול 2.הטריד 3.עקב אחרי
entrusted	מופקד
fringe	שוליים
ballot	הצבעה
superstition	אמונה תפלה
consternation	תדהמה
elucidate	להבהיר
alternatively	לחלופין
peel	לקלף
repture	להיקרע
millet	דוחן - סוג של דגן
gushed	נשפך
definitive	החלטי
gaze	מבט
permeate	לחדור
legume	קטניות
chores	מטלות
prowess	גבורה
flake	לפורר
either X or X	או ואו
sanctity	קדושה
wrenching	עיקם
Preface	הקדמה
volatility	אי יציבות
census	מפקד אוכלוסין
observance	שמירה
neither X nor X	לא ולא
plaintiff	תובע במשפט
savory	מתובל 2.ריחני
hairpin	סיכת ראש
plateau	מישור 2.העדר התקדמות או שינוי
adhesive	דביק
decree	צו
fluctuation	תנודה
ordeal	חוויה קשה
barrack	מחנה צבאי 2. לצעוק ולקלל בגסות
pang	כאב חד
inflame	להלהיט 2.להסית
in the meantime	בינתיים
resolution	החלטה
scavenge	לחטט בזבל 2.לחפש מזון 3.לנקות
pat	ליטף 2.שיטח
reiterated	חזר על עצמו שוב ושוב
leant	רכן
opt out	העדיף שלא להיות מעורב
shrewdly	בפיקחות
xerox	מכונת צילום
flatter	להחמיא
hence	לפיכך
scroll	לגלול
insomniac	אדם הסובל מנדנודי שינה
dominate	שלט
bolted	לזוז מהר בעקבות פחד
baptised	הוטבל (נצרות)
aggressor	תוקפן
inflict	גרם
nibble	לכרסם
fortification	ביצורים
to recap	לסיכום
seclude	להתבודד
interlude	קטע ביניים
thrifty	חסכן
austere	מחמיר
italicised	משנה את הכתב על מנת להדגיש אותו
testimony	עדות
delving	התעמקות
humbback	גיבנת
plank	קרש שטוח
fossil	מאובן
co	יחד
rinse	לשטוף
secrecy	סודיות
touched upon	התייחס
tenacity	עקשנות
droplet	טיפה זעירה
parish	קהילה
occlude	לחסום
fable	לספר משל
con	עם
herald	חלוץ (ראשון שבעקבותו יהיו עוד) 2.כרוז
closure	סגר
naval	שקשור לחייל הים או לספינות
arid	צחיח
essentially	בעצם
ache	כאב חד
rave	לדבר בהתלהבות
ferry	מעבורת
confederate	בעל ברית
facile	קל
conjoin	לאחד
seek	לחפש
protrude	התבלט
tiring	עייף
implementation	יישום
placid	רוגע
migratory	נודדים
censured	לנזוף
fallacy	דעה מופרכת
contra	נגד
subscription	מינוי
seemingly	לכאורה
regressed	נסוג
obscenities	גסויות
tremble	לרעוד
vintner	סוחר יין
restrict	להגביל
scholar	מלומד
falsify	לזייף
contraception	מניעת היריון
seize	לתפוס
retraced	לחזור לאחור 2.לשחזר (זיכרון)
agentic	פעולה יזומה
banister	מעקה
penance	כפרה
deportee	מגורש
idle	להתבטל
attributed	ייחס
levy	לגבות
far fetched	לא הגיוני
counter	מנוגד
immodest	לא צנוע
segregate	להפריד
wariness	זהירות
aloof	מרוחק
bequeathed	הוריש
transactional	ששייך או קשור לעסקה
emphatic	מודגש
ieisure	פנאי
counteroffer	הצעה נגדית
petty	קטנוני
self-interest	אינטרס אישי
thick	עבה 2.טיפש
hissing	שריקות
effigy	תבליט
detention	ריתוק
rustic	כפרי
curse	קללה
feat	הולם
de	היפוך
self-sufficient	עצמאי
fleeing	ברח
courtesy	אדיבות
quivering	לרעוד
vogue	אופנה
sobriquet	כינוי
extravagance	פזרנות
overthrown	הופל
secular	חילוני
feign	להעמיד פנים
defrost	להפשיר
relocate	לשנות מיקום
semi-precious	יקר למחצה
breeding	גידול
vouches for	ערב ל
hefty	חזק
dramatise	המחיז
debtor	מלווה
unanimous	פה אחד
oblivious	מתעלם
reverence	הערצה
teasing	הקנטה
immoderate	מופרז
fend	מאמץ
di	כפול
surpassed	עלה על 2.הצטיין
seniority	ותק
palely	חיוור
curtailed	הפחית
term	מונח
fend off	להדוף
dipole	דו קוטב
rendered	הוגש
poaching	ציד לא חוקי 2.גזל
concession	זיכיון 2.ויתור
snuffle	להריח
appliance	מכשיר
section	סעיף
radiate	להקרין
fervent	להוט
dis	לא
sever	לנתק
concrete	בטון 2.קונקרטי
bladelike	דמוי להב
rag	סמרטוט
evaluate	להעריך
struck	פגע
tear	לקרוע 2. דמעה
mal	רע
compliance	הענות
sew	לתפור
grapple	היאבקות 2.אחיזה
hover	לרחף
raisin	צימוק
lobe	אונה
conglomerate	תלכיד 2.צבר
undone	לבטל
succeeded	ירש
obvaite	לבטל
misconceive	להבין לא נכון
persuasion	שכנוע
authorization	אישור
slumber	תנומה
whirr	זמזום
cohere	נדבק
evident	ברור
glide	לגלוש
ransom	כופר
filthy	מזוהם
neonatal	הקשור לתינוק שרק נולד
exposure	חשיפה
shed	לשפוך 2.להפיץ 3.סככה
acupuncture	דיקור סיני
readout	קריאת נתונים
startled	מופתע
stipulation	תנאי
banished	גורש
beverage	משקה
fiscal	כספי
poly	רב
debt	חוב
shrine	מקדש
defied	התריס
broom	מטאטא
decomposition	פירוק
magnified	מוגדל
clang	לצלצל
skullcap	כיפה
provisional	זמני
flamboyant	ראוותני
postmortem	לאחר המוות
sigh	להיאנח
stranded	נטוש
scrape	לגרד
scramble	לטפס
flee	לברוח
pseudo	מדומה
sinkhole	בולען
archaic	ארכאי
errand	שליחות (משימה שניתנה למישהו להגיע למקום או להעביר חפצים כלשהם)
bypass	עקף
transitory	בר חלוף
scour	לקרצף
fleet	לחמוק 2.צי
supernatural	על טבעי
admonishmen	נזיפה
skirmish	התנגשות
adjacent	סמוך
scurry	לרוץ
triplet	שלישיה
uteri	רחם
devastate	להחריב
sting	עוקץ
flimsy	עדין
unilateral	חד צדדי
slander	לשון רע
surreptitiously	בחשאי
dismissal	פיטור של עובד
fixation	קיבעון
induction	הצטרפות
replenish	לחדש מלאי
persude	לשכנע
fling	להטיל
outermost	החיצוני ביותר
slant	לנטות
divinity	אלוהות
buttress	משען
fetch	הביא
culminating	הגיע לפסגה\לשיא
delirious	הוזה
praiseworthy	ראוי לשבח
revered	העריץ
imbue	השריש
dawdle	להתבטל
incarcerate	אסר
bobbin	סליל
premeditate	תיכנן מראש
disrepair	הזנחה
durable	מחזיק מעמד
peasant	איכר
flustered	לבלבל
propellant	חומר היוצר הנעה
abbreviation	קיצור
solicit	לשדל
decreed	גזר
oscillate	להיטלטל
fierly	בלהט
interchangeably	לסירוגין
sacrament	פולחן
facility	מתקן
xenophobia	שנאת זרים
sling	ליידות
shrewd	פיקח
foremost	החשוב ביותר
pianist	פסנתרן
sovereign	ריבונות
heretical	מנוגד לאמונות מסוימות (למה שנהוג לחשוב)
vigour	מרץ
apex	שיא
schism	פילוג
linger	להתעכב
pipe	צינור
foresee	לצפות מראש
conductivity	מוליכות
accordance	התאמה
outright	ישירות
bothersome	מעצבן
enviable	מעורר קנאה
characterizing	מאפיין
reimbursement	פיצוי
contend	התמודד
haul	לגרור
foresight	ראיית הנולד
spongy	ספוגי
splendor	פאר
infanticide	רצח ילדים
portion	חלק משלם 2.מנה (באוכל)
pane	שמשה
plead for	להתחנן בשם\עבור
pant	להתנשף
forewarn	להזהיר
defendant	נאשם
acquit	לזכות
spouse	בן או בת זוג
incest	גילוי עריות
creep	לזחול
suffocate	נחנק
distillate	מזוקק (התקבל לאחר תהליך זיקוק)
rattle	רשרוש 2. פטפט
paraphrase	ניסוח מחדש
magnificent	נהדר
acronym	ראשי תיבות
springboard	מקפצה
bestiality	אכזריות
ceiling	תיקרה
sampling	דגימה
crept	זחל
bask in	להתענג
formulate	לנסח
reversed	הפוך
affiliation	השתייכות
stake	סיכוי
foul	דוחה
fro	בחזרה
unitary	מאוחד
embedded	משובץ
misnomer	שם מטעה
parched	מיובש
forsake	להפקיר
workable	בר ביצוע
affinity	זיקה
stall	לדחות למועד אחר
pagan	פגני
contention	מחלוקת
considerable	ניכר
unyielding	משוכנע לא לשנות את דעתו
manifold	מגוון
detonate	פיצץ
intermission	הפסקה
pare	קילף
fort	מבצר
soluble	מסיס
affirm	לאשר 2.לטעון
stampede	מנוסה עקב בהלה (בדרך כלל של בעלי חיים)
unwavering	יציב
subtleties	דקויות
incongruent	לא הולם
reintegrate	שילב מחדש
bracnches	ענפים
quake	להרעיד
fortitude	אומץ לב
anniversary	יום השנה
agile	קל תנועה
transition	מעבר
entomb	לקבור מישהו או משהו
mutualism	הדדיות
salient	עיקרי
forthcoming	נגיש
circa	בסביבות
agitate	להתסיס
stardom	כוכבות
retinal	שקשור לרשתית העין
unkempt	מוזנח
fortress	מצודה
collectable	שניתן לאסוף אותו
saliva	רוק
frank	גלוי לב
dusk	בין ערביים
albeit	למרות
loosen	התיר
immortalize	הנציח
decadent	אדם מנוון ומושחת
fugitive	פליט
kettle	קומקום
frankly	בכנות
alias	שם בדוי
malicious	מרושע
bombard	להפגיז
forecast	תחזית
phase out	ביטל בשלבים
eyesore	מכוער
uncompromising	בלתי מתפשר
frantic	מטורף
indefinitely	זמן בלתי מוגבל
allot	להקצות
strain	להתאמץ
muscular	שרירי
conclusive	חד משמעי
uniting	התאחדות
preeminent	דגול
adherence	דבקות
invasive	פולשני
median	חציון
aloft	באוויר
complexion	גוון עור
acknowledged authority	סמכות מוכרת
backache	כאב גב
conviction	הרשעה
medieval	שקשור לימי הביניים
altar	מזבח
streak	פס
vibration	ריטוט
dozing	לנמנם
moratorium	דחייה או שעייה של פעולה כלשהי
transcend	התעלה
pierce	לחדור
bias	דעה קדומה
frontier	גבול
alter	לשנות
stumble	למעוד
consciously	במודע
grin	לגחך
colossal	עצום
amulet	קמע
frost	טל
perpetuate	להנציח
alumni	בוגרי מוסד מסוים
subdue	להכניע
hatched	בוקע
blouse	חולצה
slam	הטיח
octagon	מתומן
fume	לעלות עשן
preexisting	היה קיים קודם לכן
submerge	להשקיע
decimation	השמדה
zeal	להיטות
importune	להפציר
rebuke	לנזוף
envoy	שליח
fuss	להטריד
preliminary	מוקדם 2.פעולת הכנה לפני דבר מה
amend	לתקן
potent	חזק
crate	קופסה
gradually	בהדרגה
conceal	להסתיר
dowry	נדוניה 2.כישרון
distribute	להפיץ
germ	חיידק
prolong	להאריך
amiable	ידידותי
subside	לשקוט
immediate	מיידי 2.קרוב ביחסים
stimulus	גירוי
pantry	מזוה
tangerine	מנדרינה
gesture	להחוות
substantial	ניכר
imprinting	הטבעה
scolding	נזיפה
stash	לאסוף
assertively	באופן החלטי
discriminatory	מפלה
fireplace	אח (לחימום)
bamboozle	לבלבל
pensive	מהורהר
giggle	לצחקק
retrospect	בדיעבד
anchor	לעגן
succession	רציפות 2.ירושה
instinctive	שקשור לאינסטינקט
deportation	גרוש
practice	אימון
carved	חקוק
feather	נוצה
glamour	זוהר
subsequent	עוקב
annul	לבטל
lanky	גבוה רזה ורפוי
finalized	סיכם
contagious	מדבק
impeach	להדיח
compiled	מאוגד
keg	חבית קטנה
gloom	חשכה
termination	סיום
antler	קרן (של בעל חיים)
clutter	ערבוביה
consensual	בהסכמה
fence	גדר
adept	מיומנות
bargain	עסקה
glorious	מהולל
uninterrupted	רציף
apparatus	מנגון 2.מכשיר
suffix	סיומת
lurking	התגנב
tug	למשוך
coercion	כפייה
diameter	קוטר
bipartisan	דו - מפלגתי
undue	מופרז
suicide	התאבדות
facade	החלק הקדמי 2.חזות
hiss	ללחוש 2. לשרוק
seismic	שקשור לרעידות אדמה
nuisance	מטרד
fusion	היתוך
literal	מילולי
martyr	קדוש מעונה
greasy	שמנוני
abound	שופע
applicant	מועמד
sumptuous	מפואר
tortoise	צב יבשה
tenants	שוכרים (מי שגרים בדירה)
disputes	מחלוקות
drill	מקדחה 2. תרגולת
fission	ביקוע
pious	דתי
hush	להשתיק
greet	לברך לשלום
ample	הרבה
bare	חשוף 2.ריק 3.פשוט
succumb	להיכנע 2.למות
lorry	משאית
insistence	התעקשות
repugnant	מעורר שאת נפש
refrained	נמנע מ
bathe	רחץ
batter	חבט
partial	בעל העדפה ל
barn	אסם
gallant	אבירי
surge	נחשול 2.עלייה חדה
deranged	מטורלל
infrastructure	תשתיות
guarantee	ערובה
channel	ערוץ
lease	להשכיר
gallop	לדהור
extensive	נרחב
aqueduct	מוביל מים
surplus	עודף
hooted	צווח
facilitate	לסייע
rumination	הרהור
underscores	קו תחתון שנועד להדגשה
deforestation	כריתת יערות
orator	נואם
fivefold	פי חמישה
arable	קרקע שניתנת לעיבוד
sustainability	קיומות
biodegradable	מתכלה
alliance	ברית
malpractice	רשלנות פושעת
segment	קטע
immeasurable	שלא ניתן למדידה
arbitrary	שרירותי
sweep	לסחוף 2.לטאטא
skid	החליק
bride	כלה
inquiringly	בצורה של שאלה
algae	אצות
midwife	מיילדת
lens	עדשה
gaunt	כחוש
inclusive	כולל
ark	תיבה
swift	מהיר
muster	כינוס
premises	מקום
viscose	סוג של אריג
tangible	מוחשי
misplacing	מאבד
censure	ביקורת
glare	מבט חודר 2.אור מסנוור
increment	תוספת
arouse	לעורר
syllable	הברה
lump	גוש
rigorous	קפדני
ostrich	יען
cultivation	טיפוח
matriarch	אם מייסדת
mediocre	בינוני
array	לערוך
tablecloth	מפת שולחן
ragged	מרופט
Coercive	כפייתי
wheelbarrow	מריצה
scrimmage	תגרה
irritation	גירוי
provinces	מחוז
regal	מלכותי
recipient	מקבל
plaque	לוחית
devouring	טורפים
ounce	אונקייה (יחידת משקל)
tail	זנב 2.שובל 3.לעקוב
grief	יגון
practically	כמעט
cherished	העריך
narrator	קריין
obloquy	גינוי
percentile	אחוז
articulate	רהוט
rug	שטיח
duck	ברווז 2.להתחמק (ממישהו או ממשהו - אחריות)
sacked	לפטר
toll	אגרה
casually	באופן אקראי
reciprocal	הדדי
improvise	לאלתר
glimmer	להבהב
remainder	יתרה
ascend	לעלות
raspy	צורם
tram	רכבת חשמלית
unrest	אי שקט
occasionally	מדי פעם
wavelength	אורך גל
pervert	סוטה
glisten	להבהיר
bean	שעועית
ascertain	לוודא
treason	בגידה
grimace	העווה את פניו (מגועל או סלידה)
breadwinner	מפרנס
fallout	נשורת
interrogation	חקירה
audacity	חוצפה
wasteland	שממה
lattice	רשת
glitter	לזכור
ashore	על החוף
teller	כספר
hem	תפר מכפלת
boulder	סלע ענק
bankrupt	פושט רגל
fermentation	תסיסה
impersonation	התחזות
contemporary	עכשווי
obsolete	מיושן
grandeur	פאר
buffet	בופה
template	תבנית
sob	יבבה
spoils	שלל
rotten	רקוב
reviving	להחיות
intimidation	הפחדה
plight	מצוקה
grant	להעניק 2.להסכים
canned	משומר
assign	להקצות
bash	להכות
cradled	החזיק בעדינות 2.ערסל
hamper	להפריע
clad	לבוש
immunization	חיסון
mandatory	חובה
growl	לנהום
ledge	מדף
clinging	נצמד
cater	לספק
lowkey	מאופק
spilled	נשפך
cattle	עדר פרות
at odds	שרוי במחלוקת
terrain	שטח
innards	קרביים
nestled	שכון
ewe	כבשה
blunt	בוטה 2.קהה
pigment	צבע (פיגמנט)
grieve	להתאבל
cereal	דגן
attain	להשיג
tile	אריח
salivating	מזיל ריר
baffled	מבולבל
paleness	המצב שמישהו הוא חיוור
punitive	שקשור לעונש
subsequently	לאחר מכן
maintained	מתוחזק
crust	קרום
attendant	משרה
bile	מיץ מרה
grieving	מתאבל
disarray	אי סדר
divisive	מחלק
illustrated	מאוייר
cuisine	מטבח
sugarcane	קנה סוכר
constraint	אילוץ
replete	גדוש
forefront	חזית קדמית
specimen	דוגמה
contained	מרוסן 2.מוכל
grotesque	מגוחך
famine	רעב
tract	שטח 2.מערכת ביצור חי
spite	זדון
formulating	ניסח
peninsula	חצי אי
reconciled	התפייס
grudge	איבה
feast	סעודה
traiblazer	חלוץ
embankment	סוללה
staple	מצרך או מרכיב עיקרי 2.סיכה
hoard	לאגור
disintegrate	התפורר
nominating	מינה 2. הגיש מועמדות
decent	הגון
notified	הודיעו לו
grain	דגן
axis	ציר
trundle	גילגל
swab	מטוש (מקל לניקוי אוזן)
quarantining	בידד
scenic	נופי
repertoire	מאגר
inscribed	נחרט
headmaster	מנהל בית ספר
inedible	לא אכיל
transfusion	עירוי
eavesdropped	מאזינים בסתר
comet	כוכב שביט
oeuvre	יצירה
impounded	להחרים
blockades	מצור
mechanism	מנגנון
allocated	מקצה (הקצאה)
jar	צנצנת
axle	סרן
transgress	להפר
fuzzier	מטושטש יותר
abnegation	ביטול
detect	לזהות
ornament	קישוט
encountered	נפגש
hostility	איבה
backbone	עמוד שדרה 2.אומץ לב
turret	צריח
stride	פסיעה
tanned	שזוף
rhetoric	רטוריקה
shear	לגזוז
goes by	חולף
obstructed	חסום
howl	ליילל
marinate	להשרות
bail	ערבות 2.להוציא מים 3.לחלץ
cony	ארנב
infestation	פלישה של מזיקים
hoodwinked	נדהם
sagging	שקע
dampen	להרטיב משהו 2. לשכך
crease	לקפל
makes up	מפצה
hybrid	בן כלאיים
morsel	חתיכה
pioneer	חלוץ
natal	מולדת
languishing	נמג
plunging	צנח
stands for	מייצג
purchase	רכישה
hypothesis	השערה
cupboard	ארון
coincide	להתרחש בו זמנית 2.לחפוף
battalion	גדוד
examining	בוחן
rednecks	ג'ינג'ים
impairment	לקות
sanitary	תבראותי (תנאי ניקיון ששומרים על בריאות הציבור)
gives in	נכנע
hail	ברד 2.לברך לשלום
lurched	טלטול פתאומי
ensemble	מכלול של אנשים
inauguration	חניכה 2. השבעת נשיא (בארצות הברית)
scribes	פקידים
milestone	אבן דרך
conquest	כיבוש
hamlet	כפר קטן
pepper	פלפל
beehive	כוורת
truce	שביתת נשק
aristocracy	אצולה
laundry	כביסה
chauffeur	נהג
referendum	משאל עם
backdrop	רקע
fortune	הון
helmet	קסדה
befitting	יאה
trunk	תא מטען 2.חדק 3.גזע
endorsement	תמיכה
in awe of	ביראת כבוד
standby	המתנה
assembled	הורכב
pomegranate	רימון
behalf	מטעם
befriend	לסייע 2.להתחבר
tailgate	דלת אחורית (ברכב)
contemplating	מהרהר
niche	גישה מתאימה
smuggle	להבריח
shattered	מנופץ
processed	עובדו
haphazard	אקראי
sesame	שומשום
behead	לערוף ראש
uncharted	לא נודע
crafty	ערמומי
stele	מצבת אבן
lawmakers	מחוקקים
cash flow	תזרים מזומנים
indexed	מסומן
embodied	להמחיש
hand over	להסגיר
benign	שפיר 2.טוב לב
unclaimed	ללא דורש
alienated	מנוכר
acute	חד
labeling	תיוג
mosaic	פסיפס
contested	שנוי במחלוקת
restored	משוחזר
handout	נדבה
stale	עבש
emergence	הופעה
anchorman	מגיש חדשות
detracting	לגרוע
bind	לקשור 2.לחייב
doctrine	תורה
commotion	המולה
perished	נחרב
staggering	מדהים
handful	חופן
unprocessed	לא מעובד
succumbed	נכנעו
flaunted	התרברב
falsely	שלא בצדק
hassle	להטריד
vinegar	חומץ
binoculars	משקפת
underlying	שנמצא ביסודו של דבר 2.משתמע
reveal	לחשוף
hose	צינור גמיש להשקייה
deity	אלוהות
humidity	לחות
austerity	צנע
commenced	החלה
grimaced	העווה פניו
omen	אות
haste	להיחפז
yeast	שמרים
blaze	להתלקח
compassionately	בחמלה
deliberate	מכוון 2. מחושב
might	עוצמה
relented	התרצה
hasty	בהול
amphibian	דו חיי
underused	לא מנוצל כראוי
bitterly	במרירות (עם הרגשה שלילית)
peculiarities	מוזריות
tanneries	בית מלאכה לעיבוד עורות
influx	זרם
haughty	יהיר
beak	מקור 2.חוטם
blend	להתמזג
underway	בדרך
interpretation	פירוש
longitudinal	אורכי (אורך גדול)
vigilante	חברים בארגון התנדבותי שלוקחים את החוק לידיים
vend	מכר
brink	סף
haze	ערפל
beast	חיה
blueprint	תכנית
fickleness	הפכפכות
momentary	זמני
ignorant	בור
resides	התגורר
Vending machine	מכונת ממכר (מזון)
hazy	אביך
unearth	לחפור 2.לחשוף
manuscript	כתב יד
hospitable	מכניס אורחים 2.נוח
inquisitive	סקרן
consequential	חשוב
sworn	להישבע
delirium	הזייה
destitute	חסר כל
exacerbates	מחריף
harvest	קציר
heap	לערום
carnivorous	אוכל בשר
elopement	בריחה חשאית (נישואים או בריחה ממוסד כלשהו)
chastity	צניעות
relish	הנאה
culminated	הגיע לשיא
misery	אומללות
persist	להימשך
croak	קרקור
bow	להשתחוות 2.קשת
unformed	לא מעוצב 2.חסר צורה
enthusiasm	התלהבות
predisposition	נטייה קדומה
vast	נרחב
bombardment	הפצצה
junction	צומת
pursuing	עסק
hectic	קדחתני (מלא פעילות)
cub	גור
boycott	להחרים
uninhibited	חסר מעצורים
plainness	פשטות 2.ישירות
diffusion	פעפוע
mundane	רגיל
facilitated	הקל
embroil	סבוך
prejudicial	גזעני
scattering	פיזר
fauna	עולם חי
breach	הפרה
uninsured	לא מבוטח
repudiate	להתכחש 2.לדחות
mire	בוץ
emphysema	נפחת (מחלה שמתבטאת בהתנפחות רקמות)
cedar	סוג של עץ (ארז)
outskirt	פאתי
accelerated	הואצו
herd	לאסוף
bulb	נורה 2.פקעת (יצא מתוך צורה של ביצה)
uninvited	לא מוזמן
plough	לחרוש (בעזרת מחרשה)
transcendent	יוצא מן הכלל
artistry	אמנותיות
nail	מסמר
hutherto	עד כה
bestowed	הוענק
hinder	למנוע
flea	פרעוש
dish	צלחת 2.מנה
maladaptive	לא מסתגל
mourn	להתאבל
dormitory	פנימייה
interrogated	חקרו אותו
flock	עדר
bureau	לשכה
unroofed	לא מקורה
decimate	השמדה
whizz	לזוז ממש מהר
volatile	נדיף (היכולת להפוך לגז) 2. בלתי יציב
abrupt	פתאומי
impair	לפגוע
flora	עולם הצומח
busted	שבור 2.נתפס על חם
unscrew	להבריג החוצה
eccentricities	מוזר או מצחיק בדרך משעשעת
soot	פיח
malaise	מבוכה
hoax	מתיחה
valid	תוקף (סמכות)
floral	פרחוני
butler	משרת
automate	ממוחשב 2.אוטומטי
strive	לשאוף 2.להתאמץ
vices	פגמים
diversify	גיוון
scorching	לוהט
tentative	נסיוני
cherish	להוקיר
impaired	מוחלש
idiomatic	ניב (זה ניב)
reprove	לנזוף
formidable	נורא
midwives	מילדת
amnesty	חנינה
imminent	עתיד לקרות
heretic	כופר
inanimate	דומם
fur	פרווה
captivate	להקסים
dialect	ניב (שקשור לאזור גיאוגרפי)
likens	לדמות
referral	הפנייה
slim	רזה
tailor made	בהתאמה אישית
standpoint	עמדה
incidence	כמות 2.שכיחות
cargo	מטען
flute	חליל
archenemy	אויב ראשי
ladder	סולם
sluggish	אדיש
fertility	פיריון
restatement	ניסוח מחדש
contributory	תורם
infant	תינוק
goose	אווז
carriage	עגלה
exquisitely	בצורה מעולה
interferes	להפריע
dispersed	הפיץ
dock	לעגון
tendency	נטייה
infancy	ינקות
greenery	צמחייה 2.חממה
catchphrase	ביטוי קליט
variable	משתנה
ulnae	עצם האמה
insurrection	התקוממות
amplifying	הגביר
precedence	עדיפות
dwindle	להתמעט
infect	להדביק
greenhouse	חממה
catchword	מילת מפתח
variant	גרסה שונה 2.משתנה
sunken	שקוע
impeachment	האשמה
runoff	סיבוב שני (בחירות)
vary	להשתנות
cellar	מרתף
conscientious	מצפוני 2.יסודי
clerk	פקיד
routes	דרך
cremated	שרף (גוויה)
comprise	לכלול
inform	ליידע
harness	לרתום
velocity	מהירות
kiln	כבשן (שמשמש ליצירות אומנות)
course	מהלך 2.מסלול 3.מנה 4.קורס
vault	מרתף שמחזק בניין או ששומרים בו דברים
paramilitary	צבאי למחצה
withstand	לעמוד בלחץ
hawk	נץ
censor	לצנזר
barmaid	ברמנית
merger	מיזוג
clambered	לטפס
evenly	באופן שווה
insert	להחדיר
hay	חציר
vendetta	נקמת דם
paternity	אבהות
echoing	הדהוד
allege	טען
murky	חשוך
integrity	הגינות
hibernate	לישון שנת חורף
chancellor	נגיד
vendor	מוכר או מספק מוצר
pawnshop	בית עבוט
subsided	נרגע
valuation	הערכה
de facto	הלכה למעשה
intellect	חוכמה
hoof	פרסה
chariot	מרכבה
exhilarating	מלהיב
sensible	הגיוני
leased	חכור
retardant	גורם שמעכב
threshold	סף
contemplated by	נשקלו (הורהרו) על ידי
take off	להמריא
undetected	שלא מבחינים בו
revise	לתקן
sophisticated	מתוחכם
intend	לייעד
orchard	בוסתן
charter	שכר 2.כתב זכויות
exonerate	לזכות
irreconcilable	שלא ניתן לפייס עליו
exacerbate	החמיר
graspe	נתפס
chasm	תהום
viable	מעשי
abridge	לקצר
attorney	עורך דין
extravagantly	בדרך ששגורמת לך לבזבז (הרבה משאבים)
infiltrated	הסתנן
desiccated	מיובש
paved	נסלל
foreseeable	שניתן לחזותו
interpreter	פרשן
cipher	צופן
proofreading	הגהה
Practitioners	עוסקים
exploited	מנוצל
sedate	הרגיע 2.סימם
insect	חרק
lesisure	פנאי
isle	אי
pigeon	יונה
cite	לצטט
vindicate	להצדיק
handle	ידית
vendors	מוכרים
exploitation	ניצול
purr	לגרגר
clasp	אבזם 2.לחיצה
engagement	אירוסין 2.מעורבות 3.מחוייבות
gleaned	לאסוף
dismantling	פירוק
euthanize	המית בהמתת חסד
reindeer	איל
clay	חימר
ward	מחלקה
unannounced	מבלי שהוכרז
commerce	מסחר
quantitative	כמותי
resilient	גמיש
immaculate	ללא רבב
cleanse	לטהר
wax	שעווה 2.לגדול
costlier	יקר יותר
silt	טין
stratum	שכבה
trench	חפירה
deprivation	מחסור
situated	ממוקם
shepherd	רועה צאן
cleave	לבקע 2.לשסע
well-prioritized	מתועדף היטב
criteria	קריטריונים
graft	הרכיב
sanctuary	מקלט
fascinate	להקסים
labourer	פועל
sloth	עצלן 2.עצלות
manifestation	ביטוי
divergent	מסתעף 2. סוטה
whopping	גדול בצורה בלתי רגילה
deceived	מרומה
modification	תיקון
impeccable	מושלם
prolific	פורה
diversion	הסחת דעת 2.הטייה
covariance	שיתופיות
abhorrent	שנוא
stuntman	פעלולן
sprig	ענף
granular	גרגירי
flour	קמח
heart - rending	קורע לב
absolute	מוחלט
collegiate	לחבור
altruistic	זולתני
residue	שארית
implementing	יישום
alleges	טוען
implement	להטמיע
swan	ברבור
wrath	זעם
gracious	נעים הליכות
laymen	לא מקצועי
intervene	להתערב
wriggling	התפתל
inspect	לפקח
tick	קרציה 2.לתקתק
blanketed	שמיכה
commensurate	הולם
pseudonyms	שמות בדויים
manslaughter	הריגה
marsupial	חיית כיס
curating	אצר תערוכה
disdained	מזלזל
impoverished	מדולל
toad	קרפדה
pot	סיר 2.עציץ
sight	ראייה 2.השקפה
birch	ליבנה (סוג של עץ)
squaring	מתיישב
intoxicated	שתוי
implore	להפציר
tulip	צבעוני (סוג של פרח)
sip	ללגום
frail	חלש
compulsion	כפייה
inaugural	פתיחה
endorsing	מתן אישור
ombudsman	נציב תלונות הציבור
commonwealth	חבר עמים
urgently	בדחיפות
merchant	סוחר
prodigious	מפתיע
pollutants	מזהמים
poultry	עופות
faciliate	לסייע בעשיית דבר מה
agitated	הסעיר
commute	נסיעה יום יומית לעבודה 2.להמתיק עונש 3.להחליף
restrictive	מגביל
heed	לתת תשומת לב 2.להאזין
net	נטו 2.רשת
milieu	סביבה
sanitizers	חומר חיטוי
caught up with	הדבקת פערים
chew	ללעוס
by all means	בהחלט
incessant	בלתי פוסק
compel	לאלץ
indecency	מגונה
thirst	צמא 2.תשוקה
ailments	מחלות
showcased	מוצג לראווה
given rise to	עורר
folds	מכיל בתוכו
essence	מהות
incidental	מקרי 2.משני
an inference	מסקנה
holstered	נרתיק (של נשק)
godfather	סנדק
Indigenous	ילידי
prosperous	משגשג
compilation	אוסף
a promotion	קידום
reluctant	מסוייג
wane	לדעוך
unaided	ללא סיוע
dampened	לדכא 2. לדכא
buffon	ליצן
inclination	נטייה (למשהו)
underwent	עבר
braying	בכי של חמור
seclusion	הסתגרות
bark	לנבוח 2. קליפה של עץ
detour	מעקף
pillage	לבזוז
collaboration	שיתוף פעולה
rush	נהירה
foreign	זר
compound	תרכובת 2.מתחם סגור
fastened	הידק
Wailing	יללה
asylum	בית מחסה
tinsel	חוטי כסף נוצצים
hurdle	מכשול
motorized	ממונע
comprehension	הבנה
rodent	מכרסם
precarious	רעוע
scorn	לעג
mulch	כיסוי קש
recollection	זיכרון
perhaps	אולי
deliberative	במחשבה
inclined	נוטה
infidelity	כפירה
comprehensive	מקיף
ulcer	כיב
patent	פטנט
thudding	לחבוט
ingenious	גאוני
reprehensible	ראוי לגינוי
subterranean	תת קרקעי
stew	תבשיל
nestling	השעיו
conceded	הודה בהפסד
insatiable	שלא ניתן לסיפוק
casserole	קדרה
conceive	להיכנס להיריון 2.להגות
milling	טחינה
obscurity	ערפול
sprawling	התפשט
dimple	גומת חן
concierge	שוער (ביטחון)
confounded	לבלבל
inventiveness	חדשנות
mounting	עולה
contradict	לסתור
integral	בלתי נפרד
plum	שזיף 2.גוון סגול-אדמדם
merely	רק
capping	חיסה
nourishing	מזין
revelation	גילוי
notably	באופן בולט במיוחד
orchid	סחלב
concur	להסכים
whisker	שפם
dubbed	להעניק למישהו שם חיבה
discounting	הפחית
eviction	פינוי
illusive	מטעה
intelligible	מובן
slug	חילזון
concurrently	במקביל
accessory	מסייע 2.שותף 3.אביזר
exhibit	מוצג
grimacing	עיוות את פניו
spur	דורבן (להמריץ סוס) 2.להמריץ
condense	לדחוס 2.לעבות
valuate	להעריך
amphibians	דו - חיים
delved	חקר
protruding	התבלט
concede	הודה
interest	לעורר עניין 2.ריבית
feline	ממשפחת החתוליים
condolence	צער 2.תנחומים
commentary	פרשנות
eventual	בסופו של דבר
fibrous	סיבי
surreal	הזוי
pea	אפונה
limbs	גפיים
surreptitously	חשאי
abrasive	משפשף
storey	קומה
embarked	יצא לדרך
intermediate	לפשר
aerial	אווירי 2.אנטנה
culminate	להגיע לשיא
verses	פסוקים 2.בתים
molar	טוחן
veterans	יוצא צבא 2. בעל ותק
devious	ערמומי
inventory	מלאי
aerospace	מתחם החלל
chamber	תא
tapered	הצטמק
tenacious	חזק
broaden	להרחיב
reproduce	להתרבות
intersect	להיפגש
alfoat	צף
confiscate	להחרים
hesitant	הססן
hunch	תחושה 2. לקמר את הגב
alignment	מערך
recall	להיזכר
negligent	רשלני
intersection	חיתוך
altitude	גובה
conform	להתאים
snout	חוטם
renewal	חידוש
bait	לפתות
abnormal	לא נורמלי
interval	הפסקה
amidst	בין
conformity	התנהגות לפי הנהלים המקובלים
poll	סקר
suture	לבצע תפר רפואי
patchy	בלתי סדיר
particular	מסוים
aquatic	ימי
conjunction	איחוד
outdo	לעשות משהו טוב יותר
layer	שכבה
ribbon	סרט
agenda	סדר יום
intoxication	השתכרות
ascent	עלייה
connive	להעלים עין 2.לזמום
littere	מלוכלך
Brutish	בהמי
nipping	צביטה
placard	כרזה
precedent	תקדים
correspondence	התאמה
intrigue	לעניין 2.לזמום מזימה
cons	חסרונות
sift	לנפות
noticeably	באופן שקל להבחין בו
extirpations	כריתה
segregation	הפרדה
portfolio	תיק עבודות
intrusion	הפרעה
consecutive	רציף
flakes	פירורים
herbivores	אוכלי עשב
aftermath	תוצאה
brutishly	בבהמיות
iron	לגהץ
domain	תחום
conservation	שימור
provision	ספק
In spite of	למרות
stink	להסריח
common	משותף
irrespective	מבלי להתחשב ב
conserve	לשמר
procession	תהלוכה
fangs	ניבים
irrigate	להשקות
exterior	חיצוני
dislodge	לנשל
martyrs	קדושים מעונים
issue	להוציא
glacier	קרחון
consolidate	לגבש
plea	טענה
intensive	מעמיק
funerary	הלוויה
hampered	נבלם
consonant	עיצור (בדיקדוק)
cliff	צלע
commande	מצווים (ציוו עליהם)
equality	שיוויון
jeopardy	סכנה
inn	פונדק
ajar	פתוח מעט
debris	שאריות של משהו שנשבר או הושמד
resurgence	התעוררות מחדש
conversion	המרה
advertised	מפורסמים
instigate	להסית
generosity	נדיבות
jerk	לטלטל. זעזוע 2.מילת גנאי
inwards	כלפי פנים
constrict	להצר
repudiates	דוחים
smeared	מרח 2. השמיץ
acquaintance	היכרות
corporation	תאגיד
dug	חפר
lateral	צדדי
cohabitation	קשר מיני
forensic	משפטי
heightened	מוגבה
obligatory	הכרחי
latitude	קו רוחב 2.חופש פעולה
contender	מתמודד
a finely tuned	מכוון היטב
convalescence	החלמה
impurities	זיהום
straightened	מיושר
absorbent	בעל כושר ספיגה
duration	משך זמן
jolly	מהנה
mice	עכברים
an ill-fated	בעל גורל רע
profitable	רווחי
swerve	פנה
stripped	נשלל
annual	שנתי
flair	כישרון
jovial	שמח
offshore	רחוק מהחוף 2.פועל מחוץ לארץ
continuity	המשכיות
expanse	שטח רחב ופתוח
grazed	לחך
attest	מעיד
stem	לנבוע
jubilant	מאושר
orient	להתמצא 2.לכוון 3.ארצות המזרח
convey	להעביר
juggle	להטוט
cope	להתמודד
opposing	מתנגד
freelance	עצמאי
prompt	לגרום שמשהו יקרה 2.מהיר
juncture	הצטלבות בזמן
laureate	חתן פרס
patriotic	פטריותי
articulated	דיבר ברור
wrought	מחושל
juvenile	צעיר
cord	חוט
amicable	ידידותי
stimuli	גירוים
turnover	מחזור
inflicted	הסב
justapose	להציב זה לצד זה
prairie	ערבה
corps	חיל
suspension	השעייה
conduct	התנהגות
rampages	השתוללות
kneel	לכרוע ברך
correlate	לתאם
outspoken	גלוי לב
conceited	יהיר
enumerates	ספר
dune	דיונה
fiasco	כישלון חרוץ
timetable	לוח זמנים
settlement	ישוב
correspondent	להתכתב 2.להתאים
textile	אריג
nexus	קשר
parity	שוויון
punctuates	הבליט
tributary	נחל
annihilate	להשמיד
slope	מדרון
council	מועצה
painstakingly	בעמל רב
oscillation	תנודה ממצב אחד לשני (כנ״ל לגבי רגשות)
intended	מיועד
bribe	שוחד
illuminate	להאיר
kin	קרוב משפחה
square	ריבוע 2.כיכר
counsel	לייעץ
benchmark	אמת מידה
stance	עמדה
intercepted	יורט
hammock	ערסל
predominant	משתלט
delve	להתעמק
marred	פגום
edict	צו
latency	דילאי
rejuvenates	החזיר למישהו את הנעורים
outweighed	עלה עליו בחשיבותו
intestine	מעי
consultation	ייעוץ
liberation	שחרור
suburban	פרברי
counteract	לנטרל
opnesses	פתיחות
secluded	מבודד
outback	אזור נידח ולא מיושב
disgraced	מבויש
spleen	טחול
faux pas	טעות חברתית
lay	לשכב 2.לדכא
swamp	ביצה 2.להציף
accreditation	ייפוי כוח
deployed	נפרס
faux	מזוייף
insurgents	מורד
accommodated	אירח 2. העניק
pancreas	לבלב
nomad	נווד
polish	לצחצח
triangular	בעל צורה משולשת
courtyard	חצר
unscrupulous	חסר מצפון
demise	מוות
barter	סחר חליפין
trailed	עקב
alleviate	להקל
labyrinth	מבוך
upward	כלפי מעלה
craftsman	אומן
exclusively	אך ורק
sparse	דליל
reactivation	הפעלה מחדש
ingestion	הכנסת מזון
Soggy	רטוב
posed	עמד
alms	נדבה
vacuum	ריק
resorting	נופש 2.להזדקק
conceivable	מתקבל על הדעת
drapes	וילונות
cadaver	גוויה
mold	עובש
sulked	זעף
valley	עמק
dissonant	צורם
seamlessly	בצורה חלקה
coronary	שקשור ללב
barred	אסור 2. נעול
snare	לכד
predominantly	בעיקר
raged	השתולל
crooked	עקום
iterative	חזרתי
denote	לציין
inhibitory	מעכב
impeached	האשים
leverage	מינף
magnate	איל הון
contraction	צמצום
verge	סף 2.להתקרב לקצה
crossbreed	לעשות הכלאה בין המינים
complementary	משלים
anxious	חרד
sparsely	בדלילות
repealed	ביטל חוק
pylon	עמוד חשמל
portrayal	תיאור
rugged	מחוספס
larceny	גניבה
vista	נוף
cubic	מעוקב
outburst	התפרצות
rejuvenating	מחיה
preventive	מונע
spike	יתן
chatty	להגני
persistence	התעקשות
zip code	מיקוד
cultivate	לטפח
climate	אקלים
circumscribed	מוגבל
eternity	נצח
anode	אנודה - קוטב חיובי
restitute	החזיר
longing	געגועים
legislate	לחוקק
assemble	לחבר
amendment	תיקון
fluid	נוזל
prioritized	תיעדף
prosthetic	ששייך או קשור לתותבת
interface	ממשק - יחסים כללים בין הגורמים השונים
subjugation	שעבוד
leisure	פנאי
immoral	לא מוסרי
utensils	כלים
retina	רשתית (בעין)
fixture	חפצים שהם קבועים במקומם
tabulating	לערוך טבלאות
lenient	סבלני
custody	מעצר 2.משמרת
walrus	סוס ים
mandated	ייפה כוח
coup	הפיכה
customs	מכס
jagged	משונן
tuition	שכר לימוד
lethargic	רדום
wringer	מסחטה (שמוציאה מים)
pyre	מדורה
substation	תחנת משנה
prohibition	איסור
dame	גבירה
combed	מסורק
intricacies	דבר שהוא חלק ממשהו מורכב
ember	גחלת
pursued	עקב אחרי
litter	לבלגן 2.אשפה
prosecution	תביעה
debatable	נתון לוויכוח
penned	נכתב
haggard	כחוש
contradicts	סתר
annexation	סיפוח
harem	הרמון (בית נשים)
livestock	בהמות מבויתות
decadence	התנוונות
comb	מסרק
acolyte	טירון
delegate	ציר
lodge	להתאחסן 2.לינה
slum	שכונת עוני
overjoyed	מתמלא בשמחה
Figuratively	באופן מושאל
legislature	רשות מחוקקת
tranish	להכתים
grind	לטחון
gleefully	בשמחה
lodging	אכסון
skim	לרחף 2.להסיר קרום
overturned	מפיל חוק או שלטון
prejudice	דעה קדומה
commiserate	חש אמפתיה כלפי משהו
counterfeit	מזויף
summit	פסגה
absent	נעדר
dangles	משתלשל
long	ארוך 2.להשתוקק
decipher	לפענח
overrun	לעבור על גדותיו
possession	נכס
zinc	אבץ
undergone	חוה
halt	לעצור
gratify	משביע רצון
repressive	לדכא
longevity	אריכות ימים
thoroughly	ביסודיות
deduction	הסקת מסקנות 2.הפחתה
frailty	חולשה
recite	לדקלם
underage	קטין
delineate	להתוות
dispersing	פיזר
rationalization	רציונלזיציה
deed	מעשה 2.שטר קניין
discerned	מובחן
upholstery	רפידה
tireless	בלתי נלאה (עובד באנרגיה רבה בלי להתעייף)
drain	לנקז 2. לגרום למישהו להיות תשוש
bounce	לקפץ
retaining	לשמר
lucrative	רווחי
subordination	שעבוד
dough	בצק
admant	עקבי
cadence	קצב
repellent	דוחה
commend	לשבח
dispenses	מחלק
eccentric	מוזר
imitated	שמחקים אותו
stillborn	נולד מת
tenor	קול גבוה (של גבר) 2.רוח הדברים (הטון של השיח)
palpable	מוחשי
customization	התאמה אישית
yield to	נכנע ל
reprimands	גוער
lumbar	חולייתי (חלק הנמוך של עמוד השדרה)
deference	כבוד 2.היעתרות - הענות לבקשה
trembles	רועד
eulogizing	הספדה
fad	גחמה
daunting	מבהיל
adjourn	דוחה
lumber	קרשים
affliction	מחלה
resigning	פורש
ephemera	משהו שאינו נועד להישמר
intensify	הגביר
span	השתרע
bundles	חבילות
machinery	מכונות 2.מנגנון
ailment	חולי
defuse	לנטרל
wandering	משוטט
casual	לבוש לא רשמי 2.מקרי
Therein	יש בתוכו
shale	פיצל 2.סוג של סלע
staples	יסודות
lurk	לארוב
majestic	מלכותי
amnesia	איבוד זיכרון
applauding	משבח
internist	רופא פנימי
diss	העליב
currents	זרמים
malfunction	תפקוד לקוי
amputate	לכרות איבר בגוף
outrageous	מקומם
cinch	חבק
implying	מרמז
cetacean	יונק ימי
indulged	התפנק
aorta	אבי העורקים
stagnation	קיפאון
apostasy	כפירה
undercover	חשאי
mansion	ארמון
artery	עורק 2.נתיב
provoked	עורר
poised	ערוך
complement	השלים
woeful	עצוב
marble	שיש (סוג של אבן)
beard	זקן 2.להתנגד
apron	סינר 2.קידמת הבמה 3.רחבה לחנייה של מטוסים
cooker	תנור
retailer	קמנועי
merits	איכויות
margin	שוליים
cartilage	סחוס
dentures	שיניים תותבות
rebel	מורד
op-ed	מאמר דעה
stiffen	הקשה
pulley	גלגלת
conflagration	שריפה
gratitude	הכרת תודה
marginal	גבולי 2.שולי
stuffing	מילוי 2.דחוס
seething	רותח (מכעס) 2.גועש
spasm	עיוות
backpackers	תרמילאי
reprieve	המתיק את דינו
detained	נעצר
gestation	הריון
mark	לסמן 2.כתם
coffin	ארון קבורה
ricocheting	מנתז
commence	להתחיל
maternal	אמהי
conception	התעברות
deploy	להתפרס
adequately	במידה מספקת
protracted	ממושך
asset	נכס
embed	לשבץ
concussion	זעזוע מוח
squinting	פזל
plunder	לבזוז
insight	תובנה
trailblazer	חלוץ
coalition	קואלציה
advantageous	מועיל
mighty	רב עוצמה
pond	אגם
ostentiouly	באופן ראוותני
compulsive	כפייתי
mild	מתון 2.עדין
cripple	נכה
sterile	עקר 2.מחוטא
monetary	כספי
needle	מחט
mixture	תערובת
digit	אצבע 2.ספרה
derision	לעג
Billboards	שלט חוצות 2.לוח מודעות
overseen	להשגיח
undermined	התערער
garment	בגד
moan	לגנוח
dislocate	לנקוע 2.להזיז
taut	עצבני
oblivion	שכחה
feverish	קודח
proposed	מצע
withdraw	נסוג
curl	להסתלסל
deviated	לסטות
reinterpret	פירש מחדש
indictment	כתב אישום
chimney	ארובה
profound	עמוק
mob	להתקהל
receding	נסוג
mumble	למלמל
dose	מנה
wove	ארגו
ensued	התרחש לאחר מכן
affirmative	חיובי
steadfast	יציב
churned up	התכווץ
embryo	עובר המצוי ברחם
desecrate	לחלל
rueful	מעורר רחמים 2.מלא חרטה
shambled	מבולבל 2. ללכת בכבדות
scoop	דלה
induced	השפיע
expectant	כינוי לאישה הרה 2.אדם המצפה לדבר מסוים
douse	שוקע
emaciated	רזה
replenished	התחדש
unfurl	לפרוס משהו
reassure	הרגיע
feminine	נשי
desolate	שומם
staged	מבוים
snickered	צהל
convoluted	מפותל
misuse	שימוש לא ראוי\בלתי הולם
dung	דשן
forehead	מצח
nomadic	נווד
spat	רב
padding	ריפוד
incongruities	לא מתאים
maggots	רימות
certain	בטוח
manifest	ברור
fracture	לשבור
alarming	לעורר פחד
amid	בתוך 2. באמצע
gourmet	גורמה
gregarious	חברותי
twist	פינה 2. תפנית
chuckle	צחק
blurry	מטושטש
crawled	זחל
forthright	ישיר
mar	לפגום
gastric	קיבתי
scheme	תוכנית
heel	עקב 2.כרית כף היד
decay	ריקבון
riveting	מרתק
aperture	צוהר
payout	תשלום
reservation	הסתייגות 2. שמירה על מקום מראש
coordination	קורדינאציה
marvel	להתפלא 2.נס
indigestion	קלקול קיבה
detonation	פיצוץ
measurement	מדידה
contemptuous	חש בוז לגבי משהו
deluge	מבול
midst	אמצע
reactive	תגובתי
manure	דשן
herbivore	אוכלי עשב
marvelous	נהדר
detriment	נזק
pry	חיטוט
erect	זקוף
cursor	סמן (במחשב)
loose	רפוי
iris	קשתית (חלק בעין)
cringed	התכווץ 2.נירתע
reconstructive	משחזר
amalgam	אמלגמה (תרכובת של כספית עם מתכות אחרות) - משמשת רופאי שיניים
futuristic	עתידני
trajectory	מסלול
meager	דל
reluctantly	באי רצון
bisects	חצויים
in a bid	בניסיון
mudslide	מפולת בוץ
inspection	בדיקה
by means of	באמצעות
malady	מחלה
devised	המציא
arc	קשת
stigmatized	סמון כפגום
barbiturate	תרופת הרגעה
farewell	פרידה
administer	לנהל
disposition	נטייה
relic	שריד
sincere	כן
crucial	מכריע 2.חיוני
tether	קשר ברצועה
twinkle	נצנוץ
meddle	להתערב בנושאים של אחר
marrow	תמצית
plowed	שחרשו אותו
meditate	לתווך
menstruation	וסת
morose	עגמומי
lure	לפתות
coyote	זאב ערבות
surged	געש
tusk	ניב
coronal	שקשור לכתר
Medicare	בינוני
disassociate	להפריד
obstinate	עקשן
grate	לשפשף
strict	קפדן
strop	להשחיז
vegneance	נקמה
palm	כף יד 2.דקל
unfeeling	אדיש
slingshot	מקלעת בצורה של Y
occult	נסתר
centipedes	מרבה רגליים
initiatives	יוזמות
orb	גלגל
teetotaler	מתנזר באופן מוחלט למשקאות חריפים
menace	לסכן
disclose	לחשוף
mandibles	לסת תחתונה
dictatorship	דיקטטורה
cement	מלט
insomnia	נדנודי שינה
marginalize	להדיח לשוליים
solidify	מיצק
groom	לטפח 2. חתן
prenatal	שלפני הלידה
discourse	שיחה
dilapidated	רעוע
cascade	מפל מים
shun	נמנע
abdicate	ויתר על כס המלוכה
Periodically	מדי פעם
tardiness	איחור
slur	השמיץ
garnered	אסף
merit	להיות זכאי או ראוי למשהו 2.ערך
prosthesis	תוחב 2.תחליף מלאכותי
aphrodisiac	מעורר תשוקה מינית
vitreous	זגוגי
puffy	נפוח 2.מתנשף
lacerations	חתכים
eloped	לברוח
inundate	הציף
extend	להתרחב
tense	זמן דקדוקי 2. מתח
mid	באמצע
dismiss	לפטר
nearsighted	קצר ראייה
tortured	עינה
distraught	לחוץ
aid	סיוע
travail	מאמץ ניכר
respiration	נשימה
dispense	לחלק
mutilated	פצועים
hobble	ללכת בצורה כושלת
hardy	חסון
mist	לערפל
pulpit	דוכן
wave	גל
tedious	מייגע
nascent	בהתהוות
outlet	יציאה
perilous	מסוכן
pulp	חומר כתוש
sanitation	תברואה
disposal	שליטה 2.להיפטר ממשהו
Tribune	בימה
salutatory	צוהל
clinch	חבק
startle	להבהיל
scar	צלקת 2.לצלק
disproportion	יחס שגוי
drooled	הזיל ריר
cheifly	בעיקר
mitigating	הפחתה
harbinger	מבשר (מודיע מה הולך לקרות)
revenue	הכנסה
scarce	נדיר
whistle	משרוקית
lawn	בד
vultures	נשרים
balaclava	כובע גרב
upheaval	מהפך
serum	נסיוב
mount	להעפיל
syrinage	מזרק
indicate	לציין
persuaded	משוכנע
inextricable	בלתי נפרד
stigmatizing	יוצר סטיגמה
trill	סלסול (של קול)
distillation	זיקוק
brief	קצר
avalanche	מפולת שלגים
uprooting	עקר
dismay	אכזבה
thumb	בוהן
forays	גיחות
rehearsals	חזרה
apt	מתאים
persevere	להתמיד
mud	בוץ
toxin	רעלן
draft	טיוטה 2.גיוס 3.רוח פרצים
abutting	להיות סמוך
artillery	תותחנים
revolt	מרד
muffled	לכסות
tremor	רעידה
tinge	גוון
cashew	קשיו
limelight	אורות הבמה
phrase	ביטוי
murmur	למלמל 2.לנהום
droppings	גללים
heartleft	כן
commuter	נוסע
crude	גס
drove	עדר
irate	זעם
speck	נקודה
ravine	גיא
undertaking	משימה
temperament	מזג
mutiny	למרוד
urine	שתן
drought	בצורה
antihetical	מנוגד
uterus	רחם
dub	לכנות 2.לדובב
procrastination	דחיינות
microbe	חיידק
resin	שרף (של עץ)
vellum	קלף
inversely	בצורה הפוכה
declare	להצהיר
nasty	דוחה
vascular	קשור לכלי הובלה של נוזלים בגוף
lightheartedness	קלילות
access	גישה 2.זכות כניסה
alum	אחד שסיים את הלימודים האקדמיים
rigorously	בקפדנות
dates back to	מתוארך ל
nod	להנהן
wart	יבלת
dweller	תושב
bestow	להעניק
fractured	שבור
nondescript	חסר ייחוד
clot	להתקרש 2.קריש דם
brevity	קיצור
endemic	מקומי
impreganble	בלתי מנוצח
novice	טירון
indispose	להחלות 2.לפגוע בתקינות
dye	לצבוע
livelihood	פרנסה 2.חיים
chasten	לחנך
puny	חלש 2. חסר ערך
to date	עד כה
nucleus	גרעין
pore	נקבובית 2.לשקוע
To and fro	הלוך חזור fro- בחזרה
faculties	כישורים
supper	ארוחת ערב
reinstate	להחזיר למעמדו
duly	כראוי
accompanied	מלווה על ידי משהו או מישהו
limp	לצלוע
thrived	שיגשג
compact	קטן
narrate	לספר
accustomed	מורגל
celibacy	פרישות
disciples	תלמידים
assess	להעריך
emerge	מופיע
friction	חיכוך
eerily	באופן מפחיד
negate	לשלול
agility	זריזות
punctual	דייקן
cot	מיטת תינוק
blush	להסמיק
nerve	אומץ לב
allure	קסם
attic	עליית גג
forgo	לוותר
undergirded	לתמוך
exorbitant	מוגזם
artifically	באופן מלאכותי
sulk	לזעוף
detemine	לקבוע
animate	להחיות
bid	מכרז 2.הצעה 3.ניסיון 4.לאחל
refund	החזר כספי
alternate	לסירוגין
skyscraper	גורד שחקים
tutelage	חונכות
preserved	נשמר
geneorusly	בנדיבות
onset	ראשית
animosity	איבה
constructed	בנה
pulls off	מצליח
averse	מתנגד
unparalleled	שאין כמוהו
framework	מסגרת
elope	לברוח
adhere to	לדבוק ב
notorious	מפורסם 2.ידוע לשמצה
takes on	לקחת על עצמו
unification	איחוד
eased	הקלה
extension	הרחבה
abhorred	משוקץ
supertitiously	חשאי
sinew	גיד
scent	ריח
grasped	נתפסו
taxation	מיסוי
nourish	להזין
apparent	גלוי לעין
null	לא קיים
aversion	סלידה
ceased	חדל
spice	תבלין
nullify	לבטל
benevolent	נדיב
inimitable	בלתי ניתן לחיקוי
confines	גבולות
interdependencies	תלות הדדית
pelvis	אגן
healed	החלימו
emboided	להמחיש
numerical	מספרי
bewilder	לבלבל
impressionistic	מנסה להעביר רושם במקום לומר דברים מדויקים
allude	לרמוז
asserts	טוענת
unnavigable	אי אפשר לנווט בו
numerous	מרובה
conductive	מועיל 2.מוליך
mulberry	תות
enormity	ענק
literate	יודע קרוא וכתוב
alerts	מתריעה
expatriate	גולה - עזב את מדיניתו וחי באחרת
nurture	לטפח
rectungular	בצורת מלבן
militate	לפעול נגד
mannequins	בובות
precipitate	לזרז
amends	מתקנת
furnace	כבשן
prevalent	נפוץ
adaptable	שניתן להתאימו
conceptualize	להמשיג
jaundice	צהבת
intricacy	מורכבות
contain	להכיל
dissipated	התפוגג
unfathomable	בלתי מובן
hang	תולה
preamble	הקדמה
oral	שקשור לפה 2.בעל פה
bumpy	לא שטוח
transient	זמני
orbit	להסתובב
carried away	כאוטי
upbeat	חיובי
macabre	מבעית
maladjusted	לא מותאם
orphanage	בית יתומים
particle	חלקיק
herein	כאן
impetuously	בפזיזות
kinship	קרבה
pleaded	התחנן
bequest	עיזבון
deficiency	חוסר
outdated	מיושן
cocky	שחצן
commercially	מבחינה מסחרית
ennobling	כיבד
consent	להסכים
marital	זוגיות
outer	חיצוני
fragrance	ניחוח
tamer	מאלף
falsehood	שקר
slouch	הלך בריפיון
cavalier	בצורה מזלזלת
stature	גובה
input	קלט
discernible	ניתן להבחין
union	איחוד
oblige	להכריח
compassionate	רחום
blending	התמזגות
heart-rending	קורע לב
vase	אגרטל
puzzled	תמה
discreet	חשאי
admonished	לנזוף
sacred	קדוש
competent	מוכשר
martial	צבאי
dimension	מידה
artifact	חפץ
squiggly	מתפתל
pollinate	האביק
sentiment	רגש
asystole	אין פעילות חשמלית בלב
diction	הגייה
inevitable	בלתי נמנע
manipulate	הפעיל 2.תימרן
obscene	גס
intermittent	מקוטע
lush	שופע
pored over	לחקור משהו לעומק
credit	אשראי
obtain	להשיג
credible	אמין
incompatible	לא מתאים
masterminding	תיכנן
circulation	מחזור 2. תפוצה
obstruct	להכשיל
curious	סקרן
cavity	מחילה
handicap	מגבלה
noble	אצילי
treacherous	בוגדני
dilation	הרחבה
embezzle	מעילה
secured	הבטיח
vigilant	דרוך
obstruction	מכשול
cyclical	מחזורי
praise	לשבח
cervix	צוואר הרחם
burrow	מאורה
damp	לח
menageries	ביבר
instant	רגע
dearth	מחסור
briefed	להדריך
destabilizing	מערער יציבות
matured	הבשיל
odd	משונה 2.מקרי
daredevil	נועז
coral	אלמוג
travesty	פרודיה
provisions	אספקה
exodus	יציאה המונית
resented	התמרמר
mattress	מזרן
obvious	ברור
expedite	לזרז
subsidies	סבסוד
praised	זוכה לתשבוחות
dearly	ביוקר
far cry	שונה לחלוטין
bankruptcy	פשיטת רגל
starred	כיכב
bush	שיח
oncoming	מתקרב
insular	מבודד
certainty	ודאות
boisterous	רועש 2.נמרץ
graze	לרעות
tribute	הוקרה
fussed	התעסק
restore	להחזיר למצב הקודם
opinionated	עקשן
conciliate	להתפייס
goad	לדרבן
scorch	לצרוב
etched	לחרוט
rebelled	מרד
expend	לבזבז
deformed	מעוות
ostracize	לנדות
brow	מצח
logging	לחטוב (עצים)
amorous	מלא אהבה
expand	להרחיב
opportunism	ניצול כל הזדמנות
degrading	משפיל
consolation	תנחומים
peppermint	מנטה
fabrication	בדייה 2.יצירה
raw	נא
oppressor	עריץ
delicate	עדין
gown	גלימה 2.שמלת ערב
amplification	הגברה
cerebral	מוחי
oak	אלון
rash	פריחה
opt	לבחור
delight	לענג
hymns	פזמונים
conciliatory	לפייס
palsy	שיתוק
patch	טלאי
vision	חיזיון
supervise	לפקח
ordain	להסמיך
velvet	קטיפה (אריג משי)
belligerent	לוחם
supine	שוכב על הגב (פרקדן)
rim	שפה
hue	גוון
reaps	לקצור
windfall	מציאה
entailment	משמעות
fidgeted	לנוע בעצבנות
clasps	לופת
incarceration	כליאה
derailed	ירד מהפסים
cursive	רהוט
pristine	שלא נפגם
asunder	להפריד לקרעים
rod	מוט
paw	כפה של בעל חיים
gaga	קוקו
outcast	מוחרם
devalued	מוערך פחות משוויו האמיתי 2.שערכו ירד
precocity	התקדמות לפני הזמן
opulent	מפואר
soak	השרה
jammed	תקוע
aide	עוזר
penchant	נטייה חזקה
ebullient	משולהב
ensuing	בעקבותיו
deposit	להפקיד
astride	עם רגל אחת מכל צד
distinctly	באופן מובהק
outlook	התבוננות
disgust	סלידה
tepid	פושר
masking	מיסוך (הסתרה באמצעות מסיכה)
sublime	נשגב
malnourished	תת תזונה
toddler	פעוט
disparage	לזלזל
venerating	להוקיר
grueling	מפרך
humanitarian	הומניטרי
outsourcing	העברה של חלק מפעילויות הארגון לביצוע של גופים חיצוניים
inseparable	בלתי נפרד
phrasal	ביטוי
mugged	נשדד באלימות
partisan	מוטה לצד
coveted	נחשק
emanate	נבע
strangling	חונק
dizziness	סחרחורת
assort	למיין
reservoir	מאגר
impassive	אדיש
ephemeral	זמני (זמן קצר)
gnawing	כרסום
amplified	הגביר
clammy	לח ודביק
outwit	להערים על משהו
docile	כנוע
duct	ביב
completion	סיום
frown	זעף
meld	מעורבב
mosaics	פסיפס (יצירת אמנות)
stern	חמור
vestiges	שרידים
overlap	לחפוף
engraved	חרוט
castrated	מסורס
layout	מערך
awe	יראת כבוד
paintbrush	מכחול
chronicle	תיעד
relieve	להרגיע
frosted	מזוגג
overlook	להשקיף אל
revere	להעריץ
crooks	נוכלים
vigil	שמירה
perpetual	נצחי
straying	תעייה
stringent	מחמיר
wan	חיוור
rodents	מכרסמים
mercury	כספית 2. מרקורי
skidded	החליק
patrolled	סיירו
casket	ארון מתים
override	לעקוף סמכות 2.לרמוס
notrazied	אישור
compromise	הקרבה 2.פשרה
cessation	הפסקה
flatulence	גזים במערכת העיכול
pygmy	ננס
tyre	צמיג
decompose	להתכלות
darted	לזנק על משהו
diligently	בחריצות
verbosity	טרחנות
racketeering	סחיטה (פשע)
unscathed	ללא פגע
wade	להשתכשך
deflate	להתרוקן מאווויר
crumpled	מקומט
oversee	להשגיח
embittered	ממורמר
ambidextrous	שמיומן בשתי ידיו לביצוע פעולות
dumping	השלכה
posthumously	לאחר מותו
overtake	להדביק
reproached	נזף
subsiding	שוכך
tariff	תעריף
venues	מקום אירוע
concealed	הסתירו
barrettes	סיכות
reimbursed	החזיר את ההוצאות
communal	עדתי
compliant	עומד בתקן 2.צייתן
autopsy	ניתוח לאחר מוות
circulatory	מחזורי
conscious	מודע
exclusion	הרחקה
tat	לרקום
impersonated	להתחזות
intermittently	לסירוגין
retrieved	החזיר
persuasive	משכנע
muddled	מבולבל
gazed	הביטו
steady	יציב
involve	לערב
fickle	הפכפך
censorship	צנזורה
dicey	קשה
brisk	רענן
swollen	מלא
absorption	קליטה
rather	בהחלט
comatose	חסר הכרה
adulterate	מהל
shambles	בלאגן
grateful	אסיר תודה
penetrate	לחדור
ferocious	פראי
fragmented	מקוטע
converse	לשוחח
pragmatic	מעשי
doomed	הולך להיכשל
cornstarch	עמילן תירס
burdens	משאות
penetration	חדירה
proclamation	הכרזה
deduce	להסיק
inflammatory	מתסיס 2.רפואי - דלקתי
surrogate	תחליף
redistribute	חילק מחדש
pail	דלי
finite	סופי
feasible	בר ביצוע
tube of	צינור של
inured	להתחיל להתרגל למשהו
veiled	מצועף
euthanized	המית בהמתת חסד
stucco	טיח
permit	לאפשר
delegated	האצלה
ovation	תשואות
stipulate	ציין
marbles	גולות
filtered	סינן
forbidding	מאיים
perfected	בוצע בשלמות
refer	להפנות 2.להתייחס
gurney	אלונקת גלגלים (של בית חולים)
mucilage	דבק
submerse	להשקיע משהו במים
dispensed	נתן
sedan	מכונית נוסעים
personnel	סגל
bequeath	להוריש
startlingly	באופן מדהים
inexorable	נחרץ
federated	איחד בפדרציה\באיגוד
annulment	ביטול
frostbite	מכת קור
cornered	נדחק לפינה
forensics	זיהוי פלילי
philanthropy	נדנבנות
fragile	שביר
barge	להידחף
tranquil	שקט
truculent	תוקפני
avenue	שדרה 2.אמצעי
tranished	הוכתם
clover	תלתן
plane	מישור 2.מטוס
dehiscent	התנתקות
extol	הילל
ligature	קשר
entangled	הסתבך
prophetic	נבואי
landslide	מפולת 2. ניצחון ברוב מכריע
sedated	מורדם
preoccupied	מוטרד
cones	קונוסים
press	ללחוץ 2.הדפסה 3.עיתונות
fundamental	יסודי
drawn	משוך
juxtaposed	מונח זה לצד זה
magistrate	שופט שלום
sprout	נבט
chalk	גיר
prestigious	יוקרתי
titular	קיים רק בשם
bohemian	בוהמי
scalpel	אזמל ניתוחים
mobilization	ניוד
pad	לרפד (ריפוד)
galore	בשפע
prior	קודם
moved out	עזב
pastor	כומר
dissidents	מי שמתנגד למשטר
fused	מותך
rode	לרכב
priority	זכות קדימה
heavenly	שמימי או יפה מדהים
capitulate	להיכנע
brought in	הביא
put down	לדכא 2.להניח
retaliate	גמל
suitor	מחזר 2.תובע
trawl	דג בעזרת מכמורת
exceeded	חרג
probable	סביר
humility	צניעות
collaborate	לשתף פעולה
hubbub	המולה (של אנשים) -  רעש
multiple	מרובה
commoner	פשוטי עם
plundered	נשדד
huffily	בצפיפות
procedure	הליך
immature	לא בוגר
discharge	פריקה
ICU	יחידה לרפואה דחופה
hindered	מנע
halter	אפסר
hailing	לקרוא למישהו כדי למשוך את תשומת הלב
holster	נרתיק
confide	לספר סוד 2.לבטוח
notion	רעיון
tarmac	מסלול המראה
passage	מעבר
swoon	להתעלף
redo	עשה מחדש
blockade	מצור
neurosis	הפרעה נפשית
robe	חלוק
Denim	גינס
fanciful	דמיוני
plaid	אריג
windowsill	אדן החלון
fertilizer	דשן
refreshment	כיבוד 1.התרעננות
impassioned	נרגש
fanfare	קול תרועה
disputed	שנוי במחלוקת
camper	חניך
proximity	סמיכות
impatient	קצר רוח
knob	ידית עגולה 2.כפתור סיבובי
besieged	להטיל מצור
kindred	קרוב
deafen	להחריש אוזניים
contrarian	מנוגד
pulse	לדפוק
improbable	לא סביר
worn	נלבש 2.נשחק
rejoice	לשמוח מאוד
remorseful	מלא חרטה
litigious	מתדיינים (בבית משפט)
incontrovertible	בלתי ניתן לערעור
tureen	כלי קיבול למאכלים שמבשלים אותם
pour	שפך
repute	מוניטין
foal	סיח (סוס צעיר)
hyped up	נרגש
loitering	שוטטות
pacify	להרגיע
impure	לא טהור
debate	לדון 2.דיון
democratized	הפיכת משהו לנגיש
sacredness	קדושה
casualties	נפגעים
pup	בעל חיים צעיר
uproot	לעקור מן השורש
livid	כחול- אפור 2. מרוגז
pacifier	מוצץ  2.דבר מרגיע
incompetent	לא מוכשר
conspirator	קושר
drizzle	זרזיף
panting	מתנשף
metamorphosis	שינוי צורה
Thawing	הפשרה
scarlet	אדום
rescind	ביטל את התוקף
stencil	שבלונה
painstaking	מדוקדק
inconsolable	שלא ניתן לנחמו
educator	מחנך
put out	לכבות 2.לגרום לאי נוחות
fabled	מפורסם מאוד 2.אגדי
relentless	חסר רחמים
frosty	קריר
irked	עיצבן
inconvenient	לא נוח
valiant	אמיץ
withheld	להשהות
pained	כואב (נמצא במצב כזה)
masse	המוני
paramount	עליון
inert	אדיש
venerated	העריץ
poacher	צייד לא חוקי
treatise	חיבור
hare	ארנבת
acrimonious	כועס
cagey	מופנם
partake	להשתתף
conflicted	מתנגד 2.מסוכסך
variegated	ססגוני
reintroduce	להציג מחדש
readmitted	התקבל מחדש
plaudit	תשואות
brusquely	בגסות
inhospitable	לא מסביר פנים
aggravated	הכעיס
acumen	חוכמה
expropriated	הופקע (מרכוש פרטי לציבורי)
reel	סליל
suboccipital	תת - עורפי
accommodations	מגורים
toga	טוגה
ambiguity	דו משמעות
bristle	שיער או סיב 2. לכעוס
bulging	בולט
pastime	בילוי
rivulet	נחל קטן
occipital	עורפי (עורף)
compression	דחיסה
starkly	באופן בוטה
blackout	הפסקת חשמל
twicthy	חסר מנוחה
insolent	חצוף
polarity	קוטביות
recited	דיקלם
broadband	בעל טווח תדרים רחב
rapture	התלהבות
prose	פרוזה
arrayed	ערוך
perfect	לשכלל 2.מושלם
impressionable	ניתן להשפיע
compromising	התפשרות
urgency	דחיפות
mishap	תאונה
shush	השקיט
incinerate	שרף
callus	יבלת
patronize	להתנשא
intriguing	מסקרן
perceived	נתפס
cradling	עריסה
biodiversity	מגוון ביולוגי
whoop	צעקה
condos	בית משותף
abrasion	שחיקה
introspection	התבוננות פנימית
transparent	שקוף
revised	מתוקן
camaraderie	חברות אמת
profanity	ניבולי פה
womb	רחם
glib	קל לשון
rust	חלודה
intercept	לעכב
palate	חך (החלק העליון בפה)
exhortation	דברי תוכחה
millennia	אלפי שנים
irresistible	שלא ניתן לעמוד בפניו
blissful	מאושר
apatheic	אדיש
thwarted	להכשיל
tidal	גאות ושפל (עליה וירידה)
Passersby	עוברי אורח
inclusion	הכללה
peculiarly	מוזרות
sorted	ממוין
waddle	הילוך מתנודד
cloven-hoofed	פרסה שסועה
berserk	משתולל כמו מטורף
peddle	למכור
laden	עמוס
segregated	מובדל
derail	להוריד מהפסים
magnitude	גודל
bedridden	מרותק למיטה
lay off	פיטר
netting	רשת חוטים
diffidence	ביישנות
lavish	בזבזני
detestable	מתועב
belittle	לזלזל בערך
constrained	מוגבל
cane	מקל
tampering	התערב
liability	חוב
misusing	שימוש לרעה
palpitate	פועם במהירות
prospects	סיכויים
testify	להעיד
stress	לחץ
thereby	על ידי כך
carriageways	כבישים
subsist	להתקיים
penalty	עונש
vehemently	בלהט
coaster	תחתית
narration	קריינות
quadrant	רביע
frightful	מפחיד
pending	בציפייה ל
madly	בטירוף
exulting	צוהל
roller coaster	רכבת הרים
spine-chilling	מצמרר בעמוד השדרה
punctuality	דיוק
malodorous	מסריח
astray	שולל
quartile	ריבעון
exhorted	שכנע
maturity	בגרות
deformity	מום
hastened	זירז
due	צפוי
despair of	ייאוש מ
angst	חרדה
Allegedly	לכאורה
abacus	חשבונייה
infamous	ידוע לשמצה
peril	לסכן
strove	השתדל
torment	סבל
partition	חלוקה
incinerated	שרף
longitude	קו אורך
mounds	ערימות
fatalities	הרוגים
papacy	אפיפיוריות (נצרות)
bleaching	הלבנה
sachet	שקית פלסטיק
periodic	מחזורי
debilitated	מוחלש
infidel	כופר
stroll	טייל
monumental	כביר
eligible	זכאי
exotic	אקזוטי
secretion	הפרשה
reignited	הצית מחדש
triumvirate	שלטון משותף של 3 מנהיגים
walkout	שביתה
elongate	להאריך
tension	מתח
adamant	נחוש
extradite	הסגיר (למדינה אחרת)
bayonet	כידון
dupe	רימה
fraudulent	מרמה
maim	הטיל מום
nerve-wracking	מורט עצבים
posterity	צאצאים
disorienting	מבלבל
airlifted	הטיס ברכבת אוויר
perplexed	להביך
appall	לזעזע
embellish	לקשט
wreath	זר
dawned on	הגעתי להבנה (נפל האסימון)
cogitate	להרהר
scourge	פגע
incarnation	התגלמות
corrosive	מאכל
downward	כלפי מטה
restorer	משחזר
justification	הצדקה
extraterrestrial	חוצני
dote upon	להרעיף תשומת לב ואהבה
postpone	לדחות
perseverance	התמדה
plantation	מטע
duet	יצירה שמובצעת על ידי 2 אנשים
yoke	עול
dismal	מדכא
enthuse	לדבר בהתלהבות על
deceitful	ערמומי
embroidery	רקמה
fared no better	לא היה טוב יותר
chords	אקורדים
tuberculosis	שחפת
pendant	תיליון
quench	להרוות (צמא) 2. לכבות (אש)
sculpture	פסל
pervade	להתפשט
demeaning	משפיל
emit	להוציא
tight	צמוד
itch	לגרד
papal	אפיפיור
gale	סופה
pervasive	שמסוגל להתפשט/לחדור
empirical	אמפירי
dispatch	לשלוח
festive	חגיגי
tenfold	פי עשרה
gossamer	קורי עכביש
petrol	דלק
judicious	נבון
wield	משתמש 2.מניף
compensation	פיצוי
deployable	ניתן לפריסה
preception	תפיסה
preserve	לשמר
enclose	להקיף
doused	מכוסה
undaunted	עשוי ללא חת
tow	גרר
acrimony	כעס
pit	בור 2.חרצן
enclosed	מוקף
reforestation	ייעור מחדש
flapping	לנפנפף
spasms	עוויתות
accustom	להרגיל
pity	לרחם
encode	להצפין
ingested	נבלע
bargaining	להתמקח
recede	נסוג 2. התפוגג
lieutenant	סגן
surmount	להתגבר על
inimical	עוין
womaniser	רודף שמלות
ingress	כניסה
plague	להטריד
encryption	קידוד
earnestly	ברצינות
impasse	מבוי סתום
relapse	משהו רע חוזר (מחלה כלשהי)
misconduct	התנהגות בלתי הולמת
trellis	סורג
derived	נגזר מ
riddled with	רווי
odious	שנוא
requite	להחזיר טובה
cumbersome	מסורבל
disintegrated	התפרק
exult	לעלוז
conundrum	חידה
hubris	בעל ביטחון עצמי מופרז
maneuvered	תימרן
dash	ריסק
rub	לשפשף 2.בעיה 3.חיכוך
complimenting	מחמיא
freight	מטען
burgeoning	נביטה
plausible	אפשרי
emerged	התגלה
engage	להעסיק 2.להיות מעורב בעימות 3.להתארס
nullified	בוטל
inane	טיפשי
derailment	ירידה מהפסים
greif - stricken	מוכה צער
possessive	קנאי
engrave	לחרוט
onward	קדימה
vacuous	ריקני
sojourn	ביקור
precautions	אמצעי זהירות
choleric	חם מזג (מתעצבן בקלות)
pledge	להבטיח
ensue	לנבוע (ממשהו אחר)
sanctioned	לאשר
usurpers	תופסי שלטון בכוח
clairvoyance	תפיסה על טבעית
sanctify	לקדש
ceaseless	ללא הפסק
entail	להצריך 2.ירושה
vying	מתחרה
arbiter	פוסק
monetization	הפיכת משאב לכסף
pique	טינה
plow	לחרוש
entreat	להפציר
assimilated	נטמע
dint	עוצמה
tarnished	מוכתם
thunderstruck	המום
inchoate	ראשוני
proclaimed	מוצהר
by dint of	בזכות\באמצעות מאמץ רב
renowned	בעל שם
dismantle	לפרק
desperation	ייאוש
equity	הון כלכלי 2.יושר
euphoric	אופורייה
fruition	הגשמה
petrify	איבן
crotchety	זעפני
abolition	ביטול
suds	קצף סבון
penetrating	חודר
populace	תושבים
veered	סטה
clamoring	צעקני
pitifully	באופן מעורר רחמים
POW	שבוי מלחמה
notoriously	ידוע לשמצה
ligaments	רצועות (בעצמות)
drip	טפטוף
dismissed	מפוטר
approximately	בהערכה
evade	להתחמק
anticipated	צפוי
perceptual	תחושתי
transpired	התרחש
jokingly	בצחוק
restrictions	הגבלות
sweltering	לוהט
starves	מרעיב
reptilian	זוחל
bump	מכה
combustible	דליק
acclimatize	הסתגל
frustrate	לתסכל
suede	זמש (עור מעובד בעל מרקם רך)
palatable	טעים 2.קביל
traversed	לחצות
clash	התנגש
exert	להפעיל
shunning	להתרחק
urea	שתנן
thought-provoking	מעורר מחשבה
culpability	אשמה
enchanted	קסום
premature	מוקדם מדי
rekindled	ניצת מחדש
invitro	חוץ גופני
abdicating	מוותר
disclosing	לחשוף
pediatrics	רפואת ילדים
embroiled	סבוך
premise	הנחת יסוד
existence	קיום
coos	המייה
mended	תיקן
biomes	חברה אקולוגית
dejected	מדוכא
opaque	אטום
dove	יונה
uprising	התקקוממות
distorted	מעוות
expectancy	תקווה
refusal	סירוב
progeny	צאצאים
rowdy	רעשני
outgoing	חברותי
servant	משרת
impelled	מדרבן
understaffed	מחסור בכוח אדם
fidgeting	להתנועע בעצבנות או בלחץ
clenched	סגור
outpost	מאחז 2.יישוב מרוחק
rabid	כלבת 2.קנאי
implemented	מיושם
shudder	רעד
overbearing	שתטלני
expel	לגרש
attached	מצורף
ploy	תחבולה
crackdown	נקיטת אמצעים
don	לבש
explicate	לבאר
watershed	קו פרשת מים 2.נקודת מפנה
subjugated	מדוכא
bouts	התקף
scrutinise	בחן
lounge	התבטל
confided	התוודה
comparable	ניתן להשוואה
proficient	מומחה
pamper	לפנק
coerce	לאלץ
muffle	לעמעם
encrypt	קודד
auspicious	מבשר טובות
lashed	הלקה
stumbled	מעד
paralyse	לשתק
append	להוסיף
grisly	איום
beet	סלק
paralysis	שיתוק
biddable	צייתן
output	תפוקה
spelling	איות
proper	הולם
archipelago	ארכיפלג
thwart	להכשיל
amply	בשפע
compressed	דחוס
prosper	להצליח
personify	להאניש (תכונות אנושיות לחיות או חפצים)
arsonist	מצית (אדם שמצבע הצתה)
connote	מרמז
abyss	תהום
setback	מכשול
skirmishing	האבקות
jubilee	יובל
glimmered	נוצץ
medium	אמצעי 2. סביבה
demonym	תיאור של קבוצה
femicide	רצח נשים
fabricate	להמציא
distinction	הבחנה
spiraled	הסתחרר 2.הדרדר
ambulate	ללכת
byproduct	מוצר (תוצר) לוואי
bestows	להעניק
exemption	פטור
pictorial	מאויר 2.מצולם
facet	היבט
likewise	כך גם
undecipherable	בלתי ניתן לפענוח\פיצוח
dynamism	דינמי
degrade	פגם
Archery	קשתות
eroding	שחק
rebuff	דחייה
vein	כלי דם 2. מצב רוח
Fencing	סיוף (סייף)
recline	להישען
porous	נקבובי
swath	אלומה
muddle	בלבל
hectares	עשרה דונמים
distributor	מפיץ
tongs	מצבטים
scrutinize	לבדוק
quarter	רבע
far flung	מתפרס
ostensibly	לכאורה
finitude	סופיות
vegetation	צמחיה
cockpit	תא טייס
jaw-dropping	מפתיע
questionable	מוטל בספק
far out	לא מקובל
blow by	לעקוף
buckled	קרס
retorted	השיב
look out	להשגיח
averted	למנוע ממשהו להתרחש 2.להסיט מבט
snug	נעים
firebreaks	מונע אש
stirring	ערבוב
reprisal	פעולת תגמול
abnormalities	חריגות
angler	דייג
secretary	מזכירה
queer	חשוד
fertilize	להפרות 2.דשן
disabling	השבתה
torso	טורסו
pinkie	זרת
logjam	מבוי סתום (סיטואציה) 2.חסימה
arch	קשת 2. קימר
swerved	סטה
inscribe	לרשום
abort	לבטל
queue	לעמוד בתור
pungent	חריף
fidelity	נאמנות
bravado	רהבתנות
forecaster	חזאי
leapt	זינק
abstract	לא מוחשי
fixate	לקבע
coalesced	התמזגו
resenting	מתרעם
charcoal	פחם
glum	עגמומי
accentuate	להדגיש
receptive	פתוח לרעיונות חדשים
frantically	בטירוף
cooing	לדבר בצורה נעימה ואוהבת
hooked into	להתחבר למשהו
emblazoned	קישט
scoff	ללעוג
acid	חומצה
radiation	קרינה
fledgling	ציפור שזה עתה למדה לעוף 2.חסר ניסיון
unravel	להיפרם 2.לפענח
insistent	מתעקש
inapplicable	לא ישים
refined	מעודן
rupture	נקרע
despotism	רודנות
spurred	דירבן
alienate	להרחיק
phyrrhic	ניצחון פרוס (ניצחון שהושג במחיר כבד)
confiscated	מוחרם
glower	להביט בכעס
irk	להרגיז
lenience	סלחנות
tuft	ציצית
remorse	חרטה
flutter	לרפרף
fait	עובדה מוגמרת
frayed	מרופט
askew	באלכסון
dominant	דומנינטי
inherently	מיסודו
handicraft	מלאכת יד
miser	קמצן
refrigerate	לצנן
reproaching	מאשים 2.נזוף
obey	לציית
accomplie	מוגמר
alert	ערני 2.אזעקה 3.לעורר
palliative	מרגיע
relics	שרדים
detachment	ניתוק
worked up	נרגש
refuge	לתפוס מחסה
repress	להדחיק
bleak	חשוף 2.עגום
rosebuds	ורד טרום פריחתו
submerged	השקיע
annually	מדי שנה
crossfire	אש צולבת
contingent upon	מותנה ב
appetizer	מתאבן
perishable	מתקלקל במהרה
faced	מתמודד עם
careworn	מודאג ׁׁ(רואים בהבעות פנים)
reputed	מוערך כבעל מוניטין
mutter	מלמול
ratification	אישור
apprehensive	דואג
forfeit	להפסיד
ingrained	משורש
infatuated	מאוהב
resemble	דומה
inherited	עבר בירושה
ridge	רכס
resemblance	דמיון
fragment	שבריר
stalemate	מבוי סתום
coniferous	עצים מחטניים
unruly	פרוע
wardrobe	ארון בגדים
telltale	רכלן
dampness	לחות
impractical	לא מעשי
everlasting	ניצחי
nanny	אומנת
equinox	נקודות שיווי
uplifted	במצב רוח מרומם
hodgepodge	ערבוביה
aggregate	צבר
glacial	קרחוני
nettle	להקניט
slender	רזה
genus	סוג
carafe	קנקן
zealous	קנאי
chaperone	מלווה
icicle	נטיף קרח
slothful	עצל
lurch	תנודה
rendition	פרשנות 2.הסגרה למדינה אחרת 3.הופעה
tight lipped	שתקן
auction	מכרז
smug	זחוח
offshoot	שלוחה
arduous	מפרך
irrepressible	בלתי ניתן לריסון
bruising	חבלה
shoving	דחף
configure	עיצב
lugubrious	נוגה
riches	עושר
sporadic	לא סדיר
aegis	חסות
etches	חרט
roll	לגלגל 2.לצלם 3.לחמניה 4.רשימה
upsurge	פרץ
sanguine	אופטימי
drew	צייר 2.משך
reinforce	חיזק
rotate	רוטציה
goblet	גביע
infectious	מדבק
parvensu	עשיר חדש (לאחרונה זכה בעושר)
booed	קרא קריאות בוז
refinerie	בית זיקוק
abduct	לחטוף (מישהו)
rubbish	אשפה
grid	רשת
redux	מוחזר
initiative	יוזמה
tenth	עשירית
underpin	תמך מלמטה מבלי לפגוע במבנה
deadbeat	בטלן
racket	רקטה 2.המולה
strapped	קשור
ionizing	מיינן
quip	עקיצה (בדיבור)
abstention	המנעות
raid	פשיטה
factious	גורם לפילוג
poundage	משקל כולל
solidfication	התמצקות
tally	ספירה של משהו
binge	בולמוס
exultant	שמח כתוצאה מניצחון או הישג
coterie	כת
Reception	קבלת פנים
ion	יון
phosphorescent	זרחני
seeped	חלחל פנימה
quintessential	טיפוסי
citing	ציטט
ruminative	מהרהר
blackened	מושחר
dissertation	עבודת גמר
thence	משם
chanting	זימר
ebb	פחת
canister	קופסה
abstain	להימנע
thoughtlessly	בפזיזות
defer	לדחות
deferral	דחייה
girth	היקף של משהו
glossy	מבריק 2.חלק
constrain	אילוץ
coax	פיתה
tight-knit	מלוכד
edifice	מבנה
stout	איתן
slew	כמות גדולה 2. לסובב על ציר
swarm	נחיל
envelop	לעטוף
tightly	במהודק
universally	באופן אוניברסאלי
sippy	כוס עם פייה (לילד)
timidity	ביישנות
bog	ביצה
foraging	חיפוש מזון
torn	קרוע
feebly	בחולשה
tamp	לדחוס
stutter	גמגום
wholeheartedly	בלב שלם
flora and fauna	החי והצומח
goggle	לבהות בתדהמה
imbroglio	תסבוכת
rile	להרגיז
accustomed to	רגיל למשהו
tranquility	רוגע
hen	תרנגולת
ruckus	רעש
voluptuous	חושני
wean	גרם לגמילה ממשהו
sheepish	מבויש
acquaint	להכיר
curiosity	סקרנות
dissident	פורש
tune	מנגינה
contemptuously	בזלזול
quasars	גוף שמימי דמוי כוכב שמעניק הארה מדהימה
stupefaction	תדהמה
reckon	לאמוד
malleable	כפיף
truancy	היעדרות
electrification	חשמול
queues	תור
telecast	שידור טליווזיה
bimonthly	דו חודשי
flabbergasted	המום
recreation	בילוי
uncaring	אדיש
seam	תפירה
abeyance	השהיה
impairments	ליקויים
acquittal	זיכוי
recollect	להיזכר
emaciation	כחישות
epicenter	מוקד הרעש
plump	שמנמנן
entrenched	מבוצר
interred	נקבר
Refinement	עדינות
febrile	מלווה בחום גבוה
torpid	רדום
ante	דמי הימורים
obesogenic	מעודד השמנה
immersed	שקוע
assail	התקיף
undernourished	סובל מתת תזונה
captivating	שובה לב
apoplectic	זועם
reverie	חלום בהקיץ
still	הרגיע
disfigured	השחית
subtracting	מחסר - עושה פעולת חיסור
heartsick	מדוכדך
recurrent	חוזר ונשנה
harping	לחפור על משהו (במובן של לחזור על אותו הדבר)
confabulate	שוחח
mammoth	ממותה
bluntly	באופן בוטה
galling	מרגיז
admonish	להזהיר
vaguely	במעורפל
on behalf of	בשם
how come	איך זה ש? על מה ולמה?
rejection	דחייה
dims	עמעום
aghast	מוכה תדהמה
grander	גדול
adrift	להיסחף
smuggled	הבריח
precursor	מבשר
bestotted	מאוהב (עד לכדי סחרור)
torrid	לוהט
extinguished	כיבה
vanguard	חיל חלוץ - חיילים ההולכים בראש
adorn	לייפות
civic	אזרחי
foil	לסכל
elaborate	משוכלל
inaugurate	חנך
gladden	לשמח
affiliated	לספח
willful	עיקש
ceramic	קרמיקה
mill	טחנה
gouge	לנקר
suppressed	הוסתר
omit	להשמיט
regress	לחזור לאחור
woven	ארוג
misguided	מוטעה
bisecting	לחצות
cortex	קליפה
gravited	נע תחת השפעת הכובד
aberration	סטייה (מהנורמה)
staid	מיושב
agglomeration	מצבור
ambivalent	דו ערכי
obliterated	השמיד
bounteous	שופע
occupants	דיירים
gurgling	גירגר
transgressed	הפר
acquiesce	להסכים
reminiscence	זכרונות
amorphous	חסר צורה
drifts	נספחים
ouster	להדיח
blotches	כתמים גדולים
jumble	עירבב
alacrity	בקיאות
ratty	בלוי
aggravate	להחמיר
anecdote	סיפור קצר ומשעשע
trepidation	חרדה
simmer	בישל על אש קטנה
innocence	תמימות
anathema	מתועב
contrive	להמציא
anomaly	חריגה או סטייה מהנורמה
observable	בולט
torte	סוג של עוגה
bulk	חלק הארי
extraterrestrials	חוצנים
antediluvian	מיושן
apartheid	הפרדה גזעית
undetectable	בלתי ניתן לזיהוי
fall short	לא עמד בציפיות
understudy	שחקן מחליף
adversaries	יריבים
acolytes	שולייה
insofar	כל שכן ש
apocryphal	מפוקפק
prickle	לעקצץ
remedy	לרפא
apathy	אדישות
confuses	בילבל
falloff	נפילה 2.הולך ופוחת
helm	מה ששולט על ההגה בסירה (בהשאלה זה ששולט בסיטואציה\במצב)
approbation	אישור
rivert	למסמר
foreclosure	החרמת רכוש
checkers	דמקה
oppose	התנגד
chilly	צונן
assiduous	חרוץ
magnify	להגדיל
archetype	אב טיפוס
glaze	לזגג
chore	מטלה
listlessnes	אדישות
cunning	ערמומיות
Elevation	הרמה
blandishment	חנופה
openmouthed	פעור פה
renounce	דחה 2.התנער 3. זנח
ballad	בלדה
panacea	תרופה לכל
shady	מוצל (יש לו צל) 2. מפוקפק
calumny	השמצה
cowed	לגרום לו לעשות דבר מה
banner	מודעה
pointed out to	הצביע על
moat	חפיר
diluted	דליל
fidget	להזיז ידיים ורגליים ללא מנוחה
calcium	סידן
singled out for	נבחר עבור
lacuna	מרווח
scruples	היסוס
clemency	רחמים
anguish	להתייסר
canvas	בד
abstinence	פרישות
submissive	כנוע
irrefutable	לא ניתן להפרכה
pathos	חמלה
petrif	שיתוק מפחד
canyon	נקיק באזור הררי
tacit	מרומז
hebetude	קהות
commemorates	הנציח
flue	פיר
ripen	להבשיל
antagonism	התנגדות
caravan	קרוון
stun	לזעזע
ooze	נזל
swiftly	מהר
contumacious	סרבן
blanch	להלבין 2. לחלוט
antagonize	להרגיז
consented	הסכים
carbonated	מוגז
vehement	תקיף
vicissitudes	תהפוכות
morally	באופן מוסרי
griddle	מחבת לאפייה
defenestration	השלכה מהחלון
carnival	קרנבל
settler	מתיישב
improvised	מאולתר
incorrigible	חסר תקנה
graduate	סיים תואר אקדמי
deleterious	מזיק
seethe	לרתוח (רתיחה של מים) 2. לרתוח מכעס
catalyst	זרז
entrusted to	מופקד על
jittery	מוטרד
equanimity	קור רוח
tiles	אריח
despot	עריץ
renunciation	התנגדות
cellular	תאי 2.סלולרי
stare	לנעוץ מבט
reactor	כור אטומי
engulf	השקיע
squint	פזילה
diatribe	התקפה מילולית
appealing	מושך תשומת לב
abdomen	בטן
chronic	כרוני
peg	תקע
fulminate	לפוצץ בחוזקה
quashed	מבוטל
quietude	שקט
clamorous	רועש
applaud	למחוא כפיים
cliche	קלישאה
iron out	לפתור סכסוכים
oriental	מזרחי
effrontery	חוצפה
cosmopolitan	אוניברסלי
throes	כאב גדול
smidgen	קמצוץ
transcending	להתעלות
sullen	קודר
egregious	בוטה (בצורה שלילית)
exclamatory	מודגש
excavated	לחשוף עתיקות
frescoes	פרסקו
stinging	עוקץ
conceit	יהירות
retrograde	נסוג לאחור
crunched	מרוסק
enervate	להחליש
gnarled	מסוקס
appraise	להעריך
vindicated	מוצדק
cologne	בושם
clogging	הכשיל
glean	אסף
greeted	בירך
pumice	אבן ספוג
ordinance	פקודה
dustbin	פח אשפה
resurrection	תחייה
spectre	רוח רפאים
elevated	מורם
compost	קומפוסט
sapphire	ספיר (אבן יקרה)
ovary	שחלה
erase	מחק (לזכור שזה גם פועל)
posthumous	שאירע לאחר המוות
execrable	מתועב
on behalf	מטעם (מישהו)
ardent	נלהב
beetle	חיפושית
context	הקשר
ripples	אדווה (קול חלש של מים)
pummeled	היכה
ejaculate	פליטה של זרע
endorsed	אישר
advocacy	תמיכה
expunge	למחוק
on account	בגלל
hangar	מוסך מטוסים
cowboy	בוקר
complies	מתאים ל
propulsion	הכוח שדוחף משהו קדימה
poignancy	חודר
decentralized	מבוזר
in excess	בנוסף
criterion	תנאי
absorbed	מושקע
comply	נענה
duds	בגדים 2.כישלונות\נפלים
cork	פקק
contemplation	התבוננות
cyanide	ציאניד
streamline	לייעל
ensnared	לכוד
strapping	חזק
fatuous	טיפשי
virtous	ישר
aspiration	חלום
assessment	הערכה
promiscuously	בצורה מופקרת
vexed	מרוגז
rebooting	אתחול מחדש
grandiloquent	נאמר על סגנון כתיבה או דיבור -מנופח
assent	להסכים
residually	באופן שמשהו נשאר
akin	דומה 2.קרוב
erodes	נשחק
spiky	מחודד
durability	קיימות
hackneyed	שחוק
sezied	תפס
pardoned	נמחל
concoct	להכין
ragdoll	בובת סמרטוטים
harangue	תוכחה
latent	חבוי
pith	הוציא את הגרעין
hurdles	משוכה
sculptor	פסל
iconoclast	פורץ מוסכמות
index	אינדקס
wraith	רוח רפאים
bout	תקופת פעילות
creed	אמונה
voracious	רעבתני
plummeted	צנח
amputee	קטוע אברים
masonry	בנאות
indefatigable	בלתי נלאה
laconic	לקוני
carried out by	מבוצע על ידי
irritable	נרגז
doze	לנמנם
keenly	בחדות
dissertations	חיבור מדעי בשביל לקבל תואר דוקטור
mischeif	שובבות
repent	להכות על חטא
lagoon	לגונה (מפרץ מים מנותק מים)
hucksters	רוכלים 2.נוכלים
adverse	מנוגד
inure	הרגיל
ferocity	פראות
these	הנחה
indomitable	עשוי ללא בבית חית
reproach	להאשים
litigation	התדיינות
equivalent	שווה ערך
gingerly	בזהירות
bachelorhood	רווקות
legerdemain	להטוט
narrated	קריין
drooling	מרייר
curtail	הפחית
mendacious	שקרי
eliciting	מעורר
uncanny	מוזר על טבעי
overhaul	אוברול
nefarious	מרושע
bring up	מעלים
reversal	הפיכה
monochromatic	חד גווני
entertained by	מבודר על ידי
weld	לרתך
belligerently	בצורה לוחמנית
excrement	צואה
obdurate	עקשן
keep out	מגנים מפני
resolutely	בנחישות
engulfed	השקיע
cahoot	שותפות
reprised	חזר על פעולה\קטע מסוים
infrared	תת אדום
obfuscate	להחשיך
sensibly	באופן הגיוני
bitter	מר
redudant	מיותר
marsh	ביצה
administration	שלטון
prevalence	שכיחות 2.השתררות
mummification	חניטה
replicate	לשכפל
spinoff	תוצר לוואי 2. סדרת המשך
layoff	השעיה
parsimony	קמצנות
bizarre	ביזרי
trance	טרנס
affectionate	מפגין חיבה
disfluencies	חוסר שטף בדיבור
dishevel	פרוע
peculary	מוזר
foetal	עוברי
pejorative	משפיל
blossom	ללבלב
competence	יכולת
nausea	מעורר בחילה
linear	קו לינארי
severance	הפרדה
perfidious	בוגדני
shortcoming	חיסרון
branch	להסתעף
retard	לדחות
slain	הרגו אותו
diffract	שבירה של אור
atrial fibrillation	פירפור לבבי
brine	מי מלח
precipitous	תלול
budget	לתקצב
retarded	מפגר
merge	ממזג
figurative	ציורי
embolus	תסחיף
evaporation	התאדות
encase	לסגור
recalcitrant	סרבן
misty	מעורפל
derisive	לעגני
Renovation	שיפור
sagacious	נבון
bury	לקבור
retreat	לסגת
inversion	היפוך
dismantled	מפורק
burial	קבורה
retrieve	לדלות מידע 2.להשיג בחזרה
locust	חגב
fluster	לבלבל
canopy	חופה
badge	אות הצטיינות
mortgage	משכנתא
discretion	שיקול דעת 2.איפוק
properties	תכונות
carpentry	נגרות
detainee	עציר
unmanned	בלתי מאוייש
shell	קליפה
renouncing	מוותרים 2.מתכחשים
pauperization	הדרדרות לעוני
confined	תחום
forsaken	עזוב
appendage	תוספת 2.זנב
mooing	געה (עשה קול של פרה)
perforations	ניקוב
pebble	חלוקי אבן
blatant	בוטה
impromptu	מאולתר
appraisal	הערכה
fulgurate	הבזיק
declutter	השליט סדר
innocently	בתמימות
revoke	לבטל
unified	איחוד
property	רכוש
bifurcation	פיצול
outpacing	התקדם מהר יותר
undertaker	קברן
concise	מתומצת
terminate	לסיים
continuum	רצף
excruciating	מייסר
souvenirs	מזכרות
mesmerizing	היפנט
artificially	באופן מלאכותי
irriatate	מגרה
liberated	משוחרר
conical	שיש לו צורה של קונוס
braces	גשר בשיניים
anaesthetized	הלחיש
apparel	לבוש
dazzling	מסנוור
ripe	בוגר
attests to	להעיד על
initiate	ליזום
simultaneously	בו זמני
topple	הפיל
payback	החזר
communique	הודעה פומבית
stunned	הימם
barrel	חבית 2.קנה של כלי נשק
ponders	מהרהר
reiterate	חוזר על משהו שוב ושוב
rule out	פסל
barren	עקר
conciliation	פיוס
blunders	לפשל
canted	נטה בשיפוע
miscaptioned	תיאור שגוי
allusion	רמיזה
subtract	לחסר
tip	קצה
tremors	רעידות
stimulate	גירה
bashful	ביישן
mystical	מיסטי
ridicule	צחוק
frame	מסגרת
snarf	לאכול או לשתות בתאוותנות
beckon	להזמין
suspense	מתח
certified by	הוסמך על ידי 2.אושר על ידי
disillusioned	מפוכח (יצא מהאשליה)
knit	סרג
caper	מעשה קונדס 2. סוג של צמח
unrepentant	שאינו מביע חרטה
warmongering	חרם מלחמה
monitor	צג
conducive	שתורם ל
disregard	להתעלם
downhearted	מדוכדך
bellicose	גורם לריב
creased	מקומט
threefold	משולש
conjure	העלה
trite	נדוש
dictated	להכתיב
littered	ללכלך
labyrinthine	מבוך
tumbler	כוס שתייה (ללא ידית)
embodiment	התגלמות
monotonous	אחיד
disruption	הפרעה
sifted	מנופה
Proprioception	ביחס
wee	קטנטן
bewildered	לבלבל
shuffle	לטרוף
condoned	סחל
attended	נכח
semicircular	בצורה של חצי מעגל
sensuality	חושניות
motif	מוטיב
promotional	קידום מכירות
balmy	נעים
heredity	תורשה
temperamental	נוטה למצבי רוח
bigotry	אי סובלנות
silk	משי
nitrogen	חנקן
immaculately	ללא רבב
indifferent	חסר עניין
frazzled	תשוש
bigot	לא סבלני
speculate	לסבור
naunce	הבדל דק
frowning	הזעיף את פניו
energize	המריץ
chunky	שמנמן
industrious	חרוץ
bilateral	דו צדדי
cartridges	מחסנית 2. תרמיל
permits	להתיר
woebegone	מדוכדך
stiff	חזק
optical	אופטי
usurpation	תפיסת שלטון בכוח
compatibility	תאימות
fixed	קבוע 2.מתוקן
pendulum	מטוטלת
admissible	קביל
orchestra	תזמורת
rehearse	לעשות חזרות
rims	שוליים
donned	לבש
late	מאוחר 2. מנוח
flail	לחבוט
agog	נלהב
suit	להתאים 2.חליפה 3.תביעה משפטית
inject	להזריק
waned	פחת
sectors	מגזר
loafers	מוקסינים
desert	לנטוש 2. מדבר
papyrus	סוג של צמח שהיו עושים ממנו מגילות (פפירוס)
means	אמצעי
sensation	תחושה (פיזית) 2.משהו שעורר התרגשות רבה
buoyant	שמסוגל לצוף 2. עליז
swelling	התפחה
pedagogy	מקצוע ההוראה
pauper	עני
tray	מגש
ruddy	אדמדם
bore	לשעמם 2. ליצור חור
systematic	שיטתי
pedant	קפדן
deficiencies	חוסרים
countryside	אזור כפרי
subordinated	משועבד
swivel	מסתובב
scalable	יכול להתרחב\לגדול
moonstruck	מוכה ירח
savor	להריח 2.לטעום 2.לתבל 3.להנות
hallmarks	סימני היכר
noteworthy	מעניין
supplemented	מתווסף ל
suffices	מספיק
hijack	לחטוף
scant	להגביל
portal	שער
flaw	פגם
arbitrator	בורר
refurbishment	שיפוץ
portrait	דיוקן
stated	צויין
soliloquy	מונולוג עצמי
weepy	בכיין
girder	קורה
mortify	לגרום למבוכה גדולה
scope	לבחון
propeller	מדחף
unanimously	פה אחד
confounding	מבלבלים
overwrought	עצבני
racquet	מחבט
sage	חכם
forbear	להבליג
clientele	קהל לקוחות\צרכנים
string along	להתלוות
brute	פראי
distinctive	מיוחד
convulsed	טלטל
flawless	מושלם (חסר טעויות)
carcinogen	חומר מסרטן
adherent	חסיד
prune	לגזום
rendering	הדרך שמשהו כתוב
loathsome	מעורר סלידה
scrap	להשליך
sitcom	קומדית מצבים
exquisite	מעולה
informative	מחכים
outwards	כלפי חוץ
sonnet	סונטה
helix	סליל
fathom	לחדור לעומק
nutritious	מזין
bulge	לבלוט
naughty	שובב
chiefly	בעיקר
dispatched	שיגר
chafe	לשפשף
jolt	לזעזע
antitrust	הגבל עסקי
abating	הפחית
soothing	מרגיע
incompetencies	חוסר יכולת
hind	אחורי
bulwark	חומת הגנה
trek	מסע
hasten	להחיש
competency	יכולת
accumulative	מצטבר
trilogy	טרילוגיה
hatch	לתכנן 2.לבקוע מביצה
fragrant	ריחני
subvert	לערער
habitability	תכונתם של מבנה או סביבה להיות מגורים
burglar	גנב
seep	לדלוף
triviality	חוסר עומק או חשיבות
havoc	הרס
inended	מיועד
usage	נוהג
crevasse	בקע
flaunt	להתרברב
butcher	לשחוט
hazard	סכנה
inadvertent	לא מכוון
verisimilitude	סבירות
buffer zone	אזור חיץ (אזור הפרדה בין 2 ישויות פוליטיות)
versatility	רב צדדיות
hazardous	מסוכן
timbre	טון
ravenous	מאוד רעב
bustle	לזרז 2.המולה
watt	ואט
outsourced	להעביר לגורם שלישי
roaming	שוטט
implode	להתרסק כלפי פנים
headgear	כיסוי ראש
assignment	משימה
condolences	תנחומים
abhor	לתאב
cartoon	סדרה מצויירת
sheer	להימנע
pertained	קשור ל
unanimity	קונצנזוס
cunningly	בערמומיות
buoys	מצופים
splenetic	רגזן
carve	לגלף
shift	לזוז
economize	חסך
pernicious	הרסני
follow suit	הלך בדרכו
obsess	העסיק משהו בצורה מוחלטת
cashier	גזבר
reflect	שיקף
kinetic	קינטי
poleaxe	גרזן - חנית (מימי הביניים)
housebound	מרותק לביתו
rectify	תיקן
scratches	שריטות
behest	פקודה
exuberance	שפע
arraigne	העמיד לדין
disburse	שילם
maltreat	להתעלל
chairman	מנהל ישיבה
extermination	השמדה
Perversely	באופן מעוות
insubordination	מרדנות
morbidly	באופן חולני
emancipation	שחרור
stagnant	עומד
chatter	לברבר
abomination	נבלה
legitimate	לגיטימי
irredeemably	לא ניתן לתיקון
ardors	התלהבות
craftsmanship	אומנות
rear	אחורי
polymath	מלומד
ramshackle	רעוע
lay-offs	פיטור
cheek	לחי 2. חוצפה
shriek	לצרוח
curtain	וילון
immediacy	דחיפות
desertification	מידבור (הפיכת אזור יבש)
inestimable	שאין להעריכו
hijacked	נחטף
loomed	הגיח
doll	בובת צעצוע
Crucially	מכריע
tuberculous	שחפת
artisanal	ששייך או קשור לעבדתו של אומן
impending	עומד להתרחש
monsoon	רוחות וגשמים עונתיים עזים
node	קשר
arise	להתעורר
genie	שד
impenetrable	אטום
nor	גם לא
conceding	הודה 2. ויתר
militant	בעל אופי לוחמני
slack	להדלדל 2.להתרשל 3.רפוי
imperative	הכרחי
stand-still	נעצר
hump	דבובשת
vigilance	ערנות
envisages	חזה
expelled	גירש
ape	קוף אדם
imperfection	פגם
pleasantly	באופן נעים
shred	לקרוע
monetize	הפך משהו למקור רווח
quadruped	הולך על 4
rationally	רציונלי
equanimous	רגוע
hyena	צבוע (בעל חיים)
several	אחדים
custardy	פודינג
necessities	צרכים
soil	ללכלך 2.אדמה
simmered	התבשל
onlooker	משקיף
throb	פעם
condensation	התעבות
solemn	רציני 2.מעורר כבוד
odor	ריח
imprint	חותם
presides over	יושב ראש
bowel	מעי
quotas	מכסה
rummage	נבר
detected	לזהות
construct	לבנות
old-fashined	מיושן
improperly	שלא כראוי
looks into	בדק
hoist	הרים
somber	עצוב
parade	מצעד
takes after	לרשת תכונות מ-
banquets	משתאות
gripper	תפסנית
awe inspiring	מעורר יראת כבוד
conclude	להסיק 2. להסתיים
sooth	להרגיע
pearl	פנינה
unifying	להאחיד
confer	להתייעץ 2.להעניק
dichromacy	עיוורון צבעים
thereof	מזה
cradle	עריסה 2.ערש התרבות (מאיפה שתרבות מתפתחת)
sludgy	רפש
administrative	ניהולי
inception	התחלה
subatomic	תת אטומי
abnormality	חריגות
repugnance	סלידה
testament	עדות
rev	הסתובב
reflection	הרהור
sore	דלקת
broadest	הרחב ביותר
fortified	מבוצר 2.  מחוזק
grumble	רטן
repetition	חזרה
controversy	מחלוקת
surfeit	כמות שהיא גדולה מדי או מספיקה
feces	צואה
cassette	קלטת
cough	להשתעל
replica	העתק מדויק
dielectric	חומר מבודד
firmly	בתוקף
incense	קטורת 2.להכעיס
browing	השחים
kiosk	קיוסק
exported	מיוצא
caramelization	הפך לקרמל
strata	רבדים
galvanized	דירבן
dense	צפוף
retract	לחזור בו
resume	להמשיך
entrench	התחפר
deportations	גירוש
insignia	סמל
stacked	נערם
incur	להביא על עצמו (משהו שלילי)
intrusive	חודרני
chauvinisim	שובניסטיות
recuperated	החלים
pitched	נזרק 2. הוצע
implied	מרומז
sips	לגימות
relinquishing	וויתר
downturn	שפל
hardware	חומרה
forged	נוצרו
cap	פקק 2.כובע
nimble	זריז
impetuosity	פזיזות
dam	חסם
lend	להשאיל
affirate	שותף
sheet	גיליון
indispensible	הכרחי
chamois	יעלים
repartee	תשובה שנונה
petals	עלה כותרת
slash	לחתוך
induce	להשפיע
mortal	בן תמותה 2.חריף
grievances	טרונייה
imperceptible	בלתי אפשרי להרגיש אותו
spunk	אומץ לב
sequester	החרים
situate	למקם
cease	להפסיק
sleeve	שרוול
inept	בלתי מיומן
chink	סדק
temple	מקדש
inexpensive	זול
valor	אומץ
tent	אוהל
infest	לשרוץ
augmenting	להגדיל
exerted	הפעיל
eradicated	נמחק
clerical	פקידתי
dunk	טבל
spark	להצית
violin	כינור
lookout	תצפית 2.דאגה
canteen	מימייה
disinhibition	לא יכול להתאפק
allowance	דמי כיס
relapses	חזר לסורו
chalice	גביע
outgrown	התפתח במהירות 2.נגמל מדפוס התנהגות
trapezoid	טרפז
chant	לזמר
groove	חרץ 2.מנהג
imprisonment	מאסר
lozenge	מעוין
nobility	אצולה
absence	לספוג
inhabit	לאכלס
flinch	נרתע
counterparts	מקבילהם
choir	מקהלה
splendid	מצויין
accountant	רואה חשבון
predicament	מצב קשה או מביך
inducing	מעורר
foliage	עלים
permafrost	שכבת קרקע שקפואה תמיד
insidious	חתרני
immerse	להטביל
convened	התכנס
Tapestry	שטיח קיר 2.תמונת מצב מורכבת
phishing	השגה במרמה מידע בעל ערך
backward	אחורה
inherit	לרשת (לקבל בירושה)
retreat into	נסיגה לתוך
went beyond	עבר מ
forester	יערן (מומחה בטיפול עצי יער)
overgrown	גדל יתר על המידה
adolescent	מתבגר
inhibit	לעכב
diverting	משעשע 2.מסיח את הדעת
conflated	התמזגו
anyhow	בכל מקרה
inland	יבשה
Nuanced	מעודן
layered	רבוד
vocation	שליחות
sanitized	חיטא
instance	דוגמה
scrumptious	טעים 2.מעולה
reenacting	לשחזר
trampled	רמס
surpass	עלה על (מלשון עקיף)
repository	מקום אחסון
ash	אפר
suppress	דיכא
concealment	הסתרה
veal	בשר עגל
sap	להוציא מוהל מעץ
bowl over	להיות מאוד מופתע
await	להמתין
insulate	לבודד
moth	עש
terminal	סופני
abominable	מזעזע
cohesiveness	לכידות
backing	גיבוי 2.ליווי מוזיקלי
daring	נועז
Until this matter	עד שהעניין הזה
additive	תוסף
coherent	קוהרנטי
intake	קליטה
cut out	להחסיר
winding	מתפתל
battlefront	חזית הקרב
interference	הפרעה
perspiration	הזעה
bondage	עבדות
concert	קונצרט
bay	מפרץ
interject	להתערב בשיחה
intravenous	תוך ורידי
sobriety	צלילות דעת (לא שיכור - פיקח)
disproportionate	לא הולם
matruachal	שנשלט על ידי נשים
recur	לקרות שוב
commonplace	רגיל
bicultural	דו תרבותי
intermit	להפסיק זמנית
divulge	לגלות סוד
evanescent	חולף
scoffed	לעג
aristocrat	אציל
interpersonal	בין אנושי
intrusions	התערבות
raved	השתולל
disrupt	שיבש
ignominy	קלון
booth	תא
caregivers	מטפלים
boil	הרתיח
indignity	השפלה
compassion	חמלה
branding	מיתוג
designated	מיועד
inmost	הפנימי ביותר
convergence	התכנסות
breadth	רוחב
blithe	קליל 2.לא מתחשב
advert	התייחס ל_ 2. מודעה
delude	להשלות
pressing	דחוף
complacent	שאנן
inverse	הפוך
neonates	ילודים
subtle	דק
invert	להפוך
concentrated	מרוכז 2.התרכז
advisability	כדאיות
indeterminate	לא מוגדר
bridges	מגשר
merriment	עליזות
certainly	בהחלט
irradiate	להקרין
curative	מטפל
jabbering	קשקש (דיבר בצורה מהירה ולא מובנת)
wager	התערב
conditionally	בתנאי ש
indisposed	לא חש בטוב
irregularity	אי סדירות
senior	בכיר
dumbfounded	נדהם
sinking	שוקע
mystify	להוות תעלומה
superfluous	מיותר
bettor	מהמר
broody	מהורהר
supermacy	עליונות
irreversible	בלתי הפיך
decency	הגינות
utilised	מנוצל
abashed	נבוך
supreme	נעלה
effervescent	מלא שמחת חיים
makeshift	תחליף
proposition	טענה
epilogue	אפילוג
discernment	הבחנה
incontestable	ללא עוררין
ruthless	חסר רחמים
idyll	תקופת זמן מושלמת
crawl	לזחול
lace	לשרוך
teem	שפע
zodiac	גלגל המזלות
remuneration	פיצוי
presume	סבר
absentminded	מפוזר
concurrence	הסכמה כוללת
infatuation	התאהבות
rationed	הקציב
pun	משחק מילים
foretell	לנבא
concurrent	מתרחש בו זמנית
dart	חץ 2.לזנק
laxness	ריפיון
Possessed	אחוז דיבוק
condemn	להרשיע
swear	להישבע 2.לקלל
encroachment	הסגת גבול
frenzied	משוגע
atdor	להט
lineage	שושלת יוחסין
randomized	מאורגן בסדר אקראי
clandestine	חשאי
truculence	עצבנות
condescending	להתייהר
heartfelt	כן
restorative	משקם
proclivity	נטייה
campaign	קמפיין
ingenuity	תבונה
pallid	חיוור
distracted	מפוזר
plaintive	עגמומי
litigate	לטעון ולהתדיין בבית משפט
vest	העניק זכויות 2.לבש
abbreviated	מקוצר
motorcade	שיירת רכבים
lulled	הורגע
squander	בזבוז על פאר
dice	קוביות
interdependent	מצוי בתלות גומלין
impostor	מתחזה
groggy	מבולבל
confinement	מאסר
locomotion	ניידות
coordinating	תיאם
credence	אמינות
enunciate	לבטא
long-awaited	שחיכו לו זמן רב
morbidity	חולי
Red flag	דגל אדום (בהשאלה סימן שמשהו רע הולך לקרות)
guzzle	לשתות משהו הרבה ומהר
imitate	לחקות
disruptive	משבש
romp	להשתובב
band	להקה
outflow	זרימה (החוצה)
inconceivable	לא מתקבל על הדעת
innately	מיסודו
oppressive	מעיק
sepulchral	שקשור לקבר או למוות
confute	להפריך
conditioned	הוכשרו
long-winded	מייגע ומעייף בשל אורכו
conclusively	באופן משכנע
belied	הפריך
flux	זרם
pension	פנסיה
Predictive	מנבא
clip	לקצץ
blindside	להפתיע (מישהו בדבר שלילי)
hurried	זורזו
lubricate	לסוך
reminiscent	מזכיר
annotation	הסבר
imprecision	חוסר דיוק
nervy	חצוף
congregation	קהל
downside	חיסרון
crescent	חרמש
dunes	דיונות
incorporates	כלל
dwell	מתגורר
offervescent	תוסס
panes	חלונות
splotch	כתם
inquisition	אַינקווזיציה
jaunty	קליל ושופע ביטחון
drown	להטביע
navale	שקשור לחיל הים
rely	לסמוך
paroxysmal	קשור להתקף פתע
feigning	מעמיד פנים
akward	מגושם
despondent	מדוכדך
axles	צירים
gunnery	תותחנות
impeded	מעכב
loincloths	אזור חלציים
canal	תעלת מים
dynasty	שושלת
markedly	במידה ניכרת
tombstone	מצבה
stretch	להימתח
notarized	לאשר
buggy	כרכרה 2.מלא בחרקים
cabaret	מקום בידור במסעדה או בבית קפה
miffed	נעלב
fillings	סתימות
squatters	פולש
pen	עט 2. דיר
charm	קסם
inserted	הוכנס
mash	למעוך
bolt	בריח 2. ברח
convincingly	באופן משכנע
invective	קללות
inhabited	יושב (כמו תושב)
matrimony	נישואין
entertained	מבודר (שבידרו אותו)
hallucinations	הזיות
frosts	כפור
lever	דוושה
mediate	לתווך
cabin	תא
grating - Noun	סבכה שכבה שיוצרת חציצה
buds	ניצנים
crestfallen	מדוכדך
console	לנחם
mend	לתקן
implicitly	מרומז
grating - ADJ	צורם
Sanctioning	סנקציות
mercenary	שכיר חרב
stomp	רקע (עם הרגל)
convention	אמנה
parsnip	גזר לבן
adjudicator	פוסק
civilize	לתרבת
edicts	גזירות
lining	בטנה
maddening	מעצבן מאוד
pitfall	מלכודות
querulous	נרגן
condoning	סליחה
felony	עבירה
mingle	לערבב
resembled	דימה
pleas	תחינות
constituent	מרכיב 2. בוחר
plotting	תכנון
firsthand	ממקור ראשון
misdeed	מעשה לא טוב
voltage	מתח (חשמל)
outperformed	עלה בביצועו על אחר
refrigerant	מקרר
suggestive of	מזכיר את
misinterpret	לפרש שלא כהלכה
evocation	תזכורת
perimeter	היקף
module	מודול
demonstrate	להפגין
novena	תפילה רצופה של 9 ימים
rip - into	לתקוף במילים קשות
converge	להתכנס
pelvic	אגני
sanctuaries	מקדשים 2. מקלטים
exacerbation	החרפה
sychronize	לתאם מבחינת זמנים
hospitality	הכנסת אורחים
flush	לשטוף במים 2.להסמיק
auxiliary	עזר
miscellany	קובץ של פריטים שונים
fog	ערפל
to come by	להשיג
recourse	פנייה
scrawny	כחוש
fertile	פורה
cordial	ידידותי
readily	מיד 2.רצון
folk	עם
causation	סיבתיות
mounted	העפיל
reassuring	מרגיע
allocate	הקציב
reaped	לקצור
corrosion	קורוזיה
surveyor	מודד
bodily states	מצב גופני
wistfulness	עצבות
incubation	דגירה
intercede	להתערב
confrontation	חיכוך
segments	מקטעים
canine	כלב
resolved	החליט
doting	מישהו שמרעיף אהבה ותשומת לב
gymnastics	התעמלות
tractor	טרקטור
cognitive	הכרתי
serenity	שלווה
linked	קושר
omission	השמטה
warmth	חום
illuminated	מואר 2.הבהרה
moor	אדמה בוצית
capital	הון
revamp	שיפץ
cling	להיצמד
nail - biting	מותח (מביא לידי כסיסת אצבעות)
ode	פואמה
prognosis	תחזית (סיכוי החלמה- רפואי
civil	אדיב
fray	מריבה
hive	כוורת
inaccurate	לא מדויק
prosecutors	תובע
burials	קבורה
inactive	לא פעיל 2.עצל
caldera	לוע (של הר געש)
inexplicable	בלתי מוסבר
acquittals	זיכויים (במשפט)
inscriptions	כתובות
initial	ראשוני
impecunious	חסר כל
irascible	חם מזג
assorted	מגוון
firm ground	בסיס יציב
gibber	למלמל
crop	לקצץ 2.יבול
drudgery	עבודה קשה ושחורה
outlive	להתקיים יותר זמן ממישהו\משהו אחר
concern	דאגה 2.עניין
foment	המריץ
waistband	חגורה
blob	בועה
astound	להדהים
propensity	נטייה
to this end	למטרה זו
veneration	כבוד
decedent	מת
cyclone	ציקלון
leaping	מנתר
droop	להיחלש
crumble	להתפורר
ivory	שנהב
scowling	כעס
transporting	להוביל
terrace	טרסה (מדרגה בהר)
pertaining	קשור ל
interrupting	מפריע
Purportedly	לכאורה
hauling	גורר
thicken	להתעבות
crumb	פירור
mirage	תעתוע
convex	קמור
convinced	שוכנע
thermometer	מדחום
janitor	שרת
overweigh	להיות יותר ממישהו במשקל\חשיבות\בהשפעה
appetite	תיאבון
extended	הורחב
jet	סילון 2.לפרוץ
overboard	מעבר לסיפון
tousle	פרע
reexamination	בחינה מחדש
perturbed	מוטרד
quintuplet	חמישייה
accomplished	מומחה
dignitary	נכבד
reduced	הפחית
juror	מושבע
overcast	מעונן
encasing	עטיפה
reunite	לאחד
advancement	מקדמה
carbonize	פיחם
old fashioned	שמרני
theft	גניבה
forger	זייפן
privy	מידע על משהו סודי 2.שירותים
lustful	חמדני
tandem	קבוצה בת 2 חברים המסודרים יחד
seraphic	מלאכי
transmission	מסירה
overload	להעמיס יתר על המידה
aloofness	התבדלות
nonrefundable	ללא החזר
disciple	חסיד
transplant	להשתיל
lakeside	בצמוד לאגם
overpower	להכניע
inflect	היטה
exacerbated	החמיר
capturing	לכד
insurmountable	בלתי עביר
credulous	פתי
province	מחוז
upend	הפך
expansion	התפשטות
tarded in	הוחלף
divine	אלוהי
lame	צולע 2.עלוב
invasion	פלישה
deceptively	בצורה מטעה
brushed off	דחה
lane	שביל
oversimplification	פישוט יתר
tempering	ריכוך
injunction	צו מניעה
backed up	מגובה
latter	האחרון
overstate	להדגיש יתר על המידה
ancestry	שושלת
demobilization	שחרור משירות צבאי
oppress	לדכא
dosage	מינון
contempt	בוז
miscarried	הפלה טבעית 2.נכשל
adjunct	תוספת
ruling	שולט
tangle	להסתבך
drag	לגרור
literacy	ידיעת קרוא וכתוב 2.השכלה
owe	להיות חייב
entitle	כינה
impregnating	הפרייה 2.ספיגה
whistleblower	מי שחושף מעשי שחיתות
pacific	שקשור לאוקיינוס השקט 2.שקט
usable	שמיש
pallbearer	נושא מיטה
cosmetics	קוסמטיקה
cardle	עריסה
log	לתעד ביומן
pandemic	מגיפה 2.נפוץ
astonished	מדהים
throttle	משנק
dawn	לזרוח
mainland	יבשת
stamen	אבקן (של פרחים)
quay	רציף
dazzle	להדהים
mankind	כלל האנושות
parentheses	סוגריים 2.במאמר מוסגר
excavating	חפירה
inspectors	מפקחים
swatted	לחבוט
repurposes	שימוש חוזר (התאים משהו לתכלית חדשה)
devotee	חסיד
outlawed	הוצא מחוץ לחוק
peddler	סוחר
seduction	פיתוי
jersey	אפודת צמר
atone	לפצות
deafness	חירשות
middleman	מתווך (אדם שסוגר עסקאות בין אנשים)
perk	הטבה
fatality	גורליות 2.אסון
overloaded	הועמס יתר על מידה
foam	קצף
inaugurated	חונך
midget	גמד
perpetrate	לבצע (בדרך כלל פשע)
pampered	פינק
spell	לאיית
underlined	להדגיש משהו (בעזרת קו תחתון)
submit	להיכנע 2. להגיש
affluent	עמיד
incinerator	משרפה
involuntary	לא רצוני
orphaned	התייתם
decode	לפענח
Overlooked	הוזנח 2.לא התחשבו במשהו
mercilessly	בלי רחמים
reconnaissance	סיור היכרות
deduct	לנכות
thrill	להרעיד
pesticide	חומר הדברה
relentlessly	בקשיחות
saber	סיף (חרב)
mug	ספל 2.להתקיף
cumulative	מצטבר
sorcery	כישוף
novelty	חידוש
indicted	האשים
crevice	בקיע
throbbing	הולם
nudge	לעודד לפעולה 2.דחיפה
oath	שבועה
plagiarism	העתקה
lured	פיתה
supercharged	מוגדש
debilitating	מתיש
ponds	בריכה
admittance	קבלה
definite	מוגדר
deform	לעוות
tidy	נקי
occasional	מקרי
defaced	השחית
aligning	יישור
chorus	מקהלה
Skewer	שיפוד
untamed	לא מרוסן
occasionaly	לעיתים
extracurricular	חוץ לימודי
inflamed	ללבות
condenses	עיבוי
rapport	זיקה
odds	סיכויים
pretentiously	באופן יומרני
resonates	הדהד
demeanour	התנהגות
budgetary	תקציבי
execution	ביצוע
rankle	מטריד
delinquent	עבריין
ought	צריך
inadmissible	בלתי קביל
Undergrad	סטונדט לתואר ראשון
erudite	מלומד
absentee	נעדר
wonderment	התפעלות
tread	לדרוס
outgrow	להיגמל 2.לגדול מעבר למידותיו
inconsiderate	חסר התחשבות
outlaw	להוציא מחוץ לחוק 2.פושע
enrichment	העשרה
